Affrica	Afrique
Iapan	Japon
Sūðamerica	Amérique du Sud
Norþweg	Norvège
Englaland	Angleterre
Scotland	Écosse
Wēalas	Pays de Galles
Norðerne Īrland	Irlande du Nord
Īrland Cynewīse	Irlande (pays)
Ungerland	Hongrie
Spēonland	Espagne
Geānedu Rīcu American	États-Unis
Belgice	Belgique
Letseburg	Luxembourg (pays)
Eorðe	Terre
Līf	Vie
George Washington	George Washington
Finnland	Finlande
Swēoland	Suède
Denemearc	Danemark
Polaland	Pologne
Liþþuania	Lituanie
Italia	Italie
Swissland	Suisse
Ēastrīce	Autriche
Grēcland	Grèce
Turcland	Turquie
Bēor	Bière
Portugal	Portugal
Europe	Europe
Asia	Asie
Norðamerica	Amérique du Nord
Antarctica	Antarctique
Wikipǣdia	Wikipédia
Niðerland	Pays-Bas
Nīweoforwīcburg	New York
Hwæsingatūn, D.C.	Washington (district de Columbia)
Berlin	Berlin
Los Angeles	Los Angeles
Spearctelle	Ordinateur
Genf	Genève
Betweoxnett	Internet
Barack Obama	Barack Obama
Uruguay	Uruguay
Lunden	Londres
Æppel	Pomme
Paris	Paris
Abraham Lincoln	Abraham Lincoln
Android	Android
Google	Google
Mexico	Mexique
Atlantisc Gārsecg	Océan Atlantique
Sericus Gārsecg	Océan Pacifique
California	Californie
Mōnandæg	Lundi
Æfterra Gēola	Janvier
Solmōnaþ	Février
Hrēþmōnaþ	Mars (mois)
Tīw (tungol)	Mars (planète)
Cenia	Kenya
Sigelhearwenaland	Éthiopie
Ēastermōnaþ	Avril
Þrimilcemōnaþ	Mai
Sēremōnaþ	Juin
Mǣdmōnaþ	Juillet
Wēodmōnaþ	Août
Hāligmōnaþ	Septembre
Winterfylleþ	Octobre
Blōtmōnaþ	Novembre
Gēolmōnaþ	Décembre
Tīwesdæg	Mardi
Wēdnesdæg	Mercredi
Þunresdæg	Jeudi
Frīgedæg	Vendredi
Sæternesdæg	Samedi
Sunnandæg	Dimanche
Lēo	Lion
Francland	France
Esperanto	Espéranto
Geāned Cynerīce	Royaume-Uni
Catte	Chat
Cīnan Folclicu Cynewīse	Chine
Frencisc sprǣc	Français
Fisc	Poisson
Brasil	Brésil
Russland	Russie
Eoferwicscīr	Yorkshire
Sǣ	Mer
Euxinus	Mer Noire
Toronto	Toronto
Alabama	Alabama
São Paulo	São Paulo
São Paulo (rīce)	État de São Paulo
Quebec	Québec
Piza	Pizza
Þēodscland	Allemagne
Hwītrussland	Biélorussie
Þēodsc sprǣc	Allemand
Īsland	Islande
God	Dieu
Estland	Estonie
Sætern (tungol)	Saturne (planète)
Ceocōlāte	Chocolat
2 (getæl)	2 (nombre)
Þrīe	3 (nombre)
Fēower	4 (nombre)
Fīf	5 (nombre)
George W. Bush	George W. Bush
Lettland	Lettonie
Ucrægna	Ukraine
Cecland	République tchèque
Slofacia	Slovaquie
Slofenia	Slovénie
Vilnius	Vilnius
Moldofa	Moldavie
Rumǣnia	Roumanie
Pulgaraland	Bulgarie
Rōm	Rome
Macedonia Cynewīse	Macédoine (pays)
Albania	Albanie
Grēneland	Groenland
Croatia	Croatie
Bosnia and Herzegofina	Bosnie-Herzégovine
Godhopa	Nuuk
Azerbaijan	Azerbaïdjan
Andorra	Andorre
Cipros	Chypre (pays)
Georgia (land)	Géorgie (pays)
Casahstan	Kazakhstan
Melita	Malte
Flandras	Flandre (Belgique)
Monaco	Monaco
Sweartbeorg	Monténégro
Faticanburg	Vatican
San Marino	Saint-Marin
Brysel	Ville de Bruxelles
Cūba	Cuba
Barbados	Barbade
Cǣgbord (spearctellend)	Clavier d'ordinateur
Indonesia	Indonésie
Wolfgang Amadeus Mozart	Wolfgang Amadeus Mozart
Ludwig van Beethoven	Ludwig van Beethoven
Sūðaffrica	Afrique du Sud
Algeria	Algérie
Usbecastan	Ouzbékistan
Warsaw	Varsovie
Wīn (drinc)	Vin
Wæter	Eau
Holt	Bois
Feorrsīen	Télévision
Īslendisc sprǣc	Islandais
Cile	Chili
Iesus	Jésus-Christ
Elvis Presley	Elvis Presley
Wōden (tungol)	Mercure (planète)
Stǣr	Histoire
Apple Inc.	Apple
Frig (tungol)	Vénus (planète)
Sprǣc	Langage
Lufu	Amour
Þunor (tungol)	Jupiter (planète)
Uranus	Uranus (planète)
Neptune (planēta)	Neptune (planète)
Tungolcræft	Astronomie
Witancræft	Science
Pluto	Pluton (planète naine)
Montreal	Montréal
Lēohtenstān	Liechtenstein
Plega	Sport
Grantanbrycg	Cambridge
Adolf Hitler	Adolf Hitler
Fyrst Woruldgūþ	Première Guerre mondiale
Ōðru Woruldgūþ	Seconde Guerre mondiale
Wikibēc	Wikibooks
Augusto Pinochet	Augusto Pinochet
Geanca Cupala	Ivan Loutsévitch
Ubuntu	Ubuntu
Stettin	Szczecin
Rīmcræft	Mathématiques
U2	U2
Lǣden	Latin
Bahrain	Bahreïn
Armenia	Arménie
Serbia	Serbie
Mōna	Lune
Constantinopolis	Istanbul
Australia	Australie
Bob Marley	Bob Marley
Argentina	Argentine
Peru	Pérou
Norþcorēa	Corée du Nord
Cambodia	Cambodge
Kuiperes gyrtel	Ceinture de Kuiper
Curān	Coran
Alladōm	Islam
Lech Wałęsa	Lech Wałęsa
Europisce Gesamnung	Union européenne
Woruldwīd Webb	World Wide Web
Wīf	Femme
Wætertyge	Aqueduc
Don Quijote	Don Quichotte
Megelan	Milan
Burg	Ville
Napoleon I Francena Cāsere	Napoléon Ier
Uesuuius	Vésuve
Sunne	Soleil
Lēohtgēar	Année-lumière
Sunnlicu Endebyrdnes	Système solaire
Ostsǣ	Mer Baltique
Wisle	Vistule
Tōþ	Dent
Wætertimber	Hydrogène
Wikimedia Commons	Wikimedia Commons
Dæg	Jour
Ēasttimor	Timor oriental
Niht	Nuit
Gēar	Année (calendrier)
Hundgēar	Siècle
Rīn	Rhin
Oslo	Oslo
Katowice	Katowice
1 Ceres	(1) Cérès
Ii	Iona (Écosse)
Dubai	Dubaï (émirat)
Folga	Volga
Æðmlyft	Oxygène
Dweligende tungol	Planète
Venetia	Venise
Naruto	Naruto
Moscow	Moscou
Italisc sprǣc	Italien
Cead	Tchad
Nīwe Sǣland	Nouvelle-Zélande
Indea	Inde
Īsen	Fer
Willelm Scacaspere	William Shakespeare
Lēad	Plomb
Mongolland	Mongolie
Ficgīege	Fidji
Feneswela	Venezuela
Blēobord	Échecs
Maine	Maine (État)
Hors	Cheval
Amsterdam	Amsterdam
Wǣpen	Arme
Dēor	Animal
Paraguay	Paraguay
Ecuador	Équateur (pays)
Colombia	Colombie
Strēawberge	Fragaria
Buddendōm	Bouddhisme
Bolifia	Bolivie
Coper	Cuivre
Plante	Plante
Nīwu Hāmtūnscīr	New Hampshire
Iamaica	Jamaïque
Massachusetts	Massachusetts
Connecticut	Connecticut
Henn	Gallus gallus domesticus
Hawaii	Hawaï
Cēsarēa	Jersey
Swīn	Porc
Īshæf	Océan Arctique
Persealand	Iran
Irac	Irak
Alaska	Alaska
Israhēl	Israël
Utrecht	Utrecht
Gemen	Yémen
Clēofanwyrm	Virus
Polisc sprǣc	Polonais
Hascemisc Cynerīce þæs Iordanes	Jordanie
Florida	Floride
Arizona	Arizona
Cuwait	Koweït
Libanus	Liban
Oregon	Oregon
Utah	Utah
Hriðer	Bos taurus
Malægsia	Malaisie
Burma	Birmanie
Oman	Oman
Pacistan	Pakistan
Qatar	Qatar
Tennis	Tennis
Saudisc Arabea	Arabie saoudite
Tāprabane	Sri Lanka
Iosep Stalin	Joseph Staline
Syria	Syrie
Plato	Platon
Tacgicastan	Tadjikistan
Aristoteles	Aristote
Thailand	Thaïlande
Ūtƿeorp	Radiodiffusion
Turcmenistan	Turkménistan
Geānedu Arabisc Bregorīcu	Émirats arabes unis
Fietnam	Viêt Nam
Sūþcorēa	Corée du Sud
Afghanistan	Afghanistan
J. R. R. Tolkien	J. R. R. Tolkien
Gold	Or
Bængladesc	Bangladesh
Bleach (manga)	Bleach (manga)
Socrates	Socrate
Angola	Angola
Tansania	Tanzanie
Philippines	Philippines
Middel Affricanisc Cynewīse	République centrafricaine
Sūþende þǣre eaxe	Pôle Sud
Norþende þære eaxe	Pôle Nord
Isaac Newton	Isaac Newton
Albert Einstein	Albert Einstein
Geolu	Jaune
Tunisia	Tunisie
Simbabwe	Zimbabwe
Beicing	Pékin
Sūþsudan	Soudan du Sud
Botswana	Botswana
Burkina Faso	Burkina Faso
Folcrīcelicu Cynewīse þæs Congwes	République démocratique du Congo
Bægwaraland	Bavière
Baden-Wyrttemberg	Bade-Wurtemberg
Æriþrea	Érythrée
Nīwe Delhi	New Delhi
Iohannes Paulus II Pāpa	Jean-Paul II
Gabon	Gabon
Mohandas Karamchand Gandhi	Mohandas Karamchand Gandhi
Gambia	Gambie
Guinea	Guinée
Elpendbānrima	Côte d'Ivoire
Camerun	Cameroun
Grēnenæs Īega	Cap-Vert
Lesotho	Lesotho
Liberia	Liberia
Libia	Libye
Madagascar	Madagascar
Mauritania	Mauritanie
Morocco	Maroc
Mosambice	Mozambique
Namibia	Namibie
Nigeria	Nigeria
Charles Darwin	Charles Darwin
Uganda	Ouganda
Rwanda	Rwanda
Sōmalia	Somalie
Gaius Iulius Caesar	Jules César
Sudan	Soudan
Swasiland	Swaziland
Hamburg	Hambourg
Heorte	Cœur
Brægen	Cerveau
Prag	Prague
Bleoh	Bleu
Seolfor	Argent
Tin	Étain
Reddit	Reddit
Elsass	Alsace
Bihar	Bihar
Michigan	Michigan
Puerto Rico	Porto Rico
Niðerseaxland	Basse-Saxe
Hetwaraland	Hesse (Land)
Illinois	Illinois
Norþdakota	Dakota du Nord
Brandenburg	Brandebourg
Langbeardnaland	Lombardie
Sūþdakota	Dakota du Sud
Montǣna	Montana
Wyoming	Wyoming
Ierusalem	Jérusalem
Idaho	Idaho
Hwæsingatūn	Washington (État)
Nevada	Nevada
Danais	Don (fleuve)
Indisc Gārsecg	Océan Indien
Caribisc Sǣ	Mer des Caraïbes
Colorado	Colorado
Tuscania	Toscane
Alpis	Alpes
Gænt	Gand
Chicago	Chicago
The Beatles	The Beatles
Winter	Hiver
Ēawielm	Printemps
Efenniht	Équinoxe
Spēonisc sprǣc	Espagnol
Caligardamana	Calcutta
West Bengal	Bengale-Occidental
Ātorcoppe	Araneae
Virginia	Virginie (État)
Westvirginia	Virginie-Occidentale
Nīwe Eoforwīc	État de New York
Rhode Īeg	Rhode Island
Ceorfdēor	Insecte
Marianland	Maryland
Delaware	Delaware
Fladimir Lenin	Vladimir Ilitch Lénine
Ohio	Ohio
Pennsylvānia	Pennsylvanie
Uetersen	Uetersen
Augustus	Auguste
Microsoft Windows	Microsoft Windows
Nīwe Cēsarēa	New Jersey
Calpis	Gibraltar
Finnisc sprǣc	Finnois
Indiǣna	Indiana
Selffērende wægn	Automobile
Roger Federer	Roger Federer
Georgia (America)	Géorgie (États-Unis)
Marcus Aurelius	Marc Aurèle
Texas	Texas
Puilla	Pouilles
Norþcarolīna	Caroline du Nord
Sūþcarolīna	Caroline du Sud
Sicilia	Sicile
Sardinia	Sardaigne
Ligore	Loire
Sigen	Seine
Buenos Aires	Buenos Aires
Mexicoburg	Mexico
Pīnæppel	Ananas
Mississippi	Mississippi (État)
Mississippi ēa	Mississippi (fleuve)
Mizoram	Mizoram
Tennessee	Tennessee
Abu Dhabi	Abou Dabi (ville)
Nīwe Mexico	Nouveau-Mexique
Athēnas	Athènes
Minnesota	Minnesota
Wisconsin	Wisconsin
Iowa	Iowa
Nebraska	Nebraska
Kansas	Kansas
Hafana	La Havane
Pīpwēod	Tabac
Missouri	Missouri (État)
Louisiāna	Louisiane
Nagaland	Nagaland
Kentucky	Kentucky
Arkansas	Arkansas
Ælf ēa	Elbe (fleuve)
Oklahoma	Oklahoma
Donua	Danube
Hæfel	Havel
Norþsǣ	Mer du Nord
Flēogeball	Volley-ball
Uigenna	Vienne (Autriche)
Cēapmannahæfen	Copenhague
Stoccholm	Stockholm
Helsinki	Helsinki
Difelin	Dublin
Rēcwīc	Reykjavik
Riga	Riga
Dantsic	Gdańsk
Frankfurt	Francfort-sur-le-Main
Death Note	Death Note
Biblioþēce	Bible
Ho Chi Minh Burg	Hô-Chi-Minh-Ville
Sōþ Iesus Cirice	Véritable Jésus Église
Nīwenglisc sprǣc	Anglais
Andorra la Vella	Andorre-la-Vieille
Đồng Hới	Đồng Hới
Concepcion	Concepción (Chili)
Cænugeard	Kiev
Ontario	Ontario
Ottawa	Ottawa
Alberta	Alberta
Nīwe Scotland	Nouvelle-Écosse
Końskowola	Końskowola
Geocon Landscipe	Yukon
Florentia	Florence
Ǣt	Nourriture
Snaca	Serpentes
Halifax	Halifax (Nouvelle-Écosse)
Quebecceaster	Québec (ville)
3. Æfterran Gēolan	3 janvier
4. Æfterran Gēolan	4 janvier
Región del Biobío (Cile)	Région du Biobío
5. Æfterran Gēolan	5 janvier
Arica	Arica (Chili)
6. Æfterran Gēolan	6 janvier
7. Æfterran Gēolan	7 janvier
8. Æfterran Gēolan	8 janvier
9. Æfterran Gēolan	9 janvier
10. Æfterran Gēolan	10 janvier
11. Æfterran Gēolan	11 janvier
12. Æfterran Gēolan	12 janvier
13. Æfterran Gēolan	13 janvier
Beormingahām	Birmingham
14. Æfterran Gēolan	14 janvier
15. Æfterran Gēolan	15 janvier
16. Æfterran Gēolan	16 janvier
17. Æfterran Gēolan	17 janvier
18. Æfterran Gēolan	18 janvier
Rōmānisc Rīce	Empire romain
Microsoft	Microsoft
30. Æfterran Gēolan	30 janvier
Kurów	Kurów
11. Solmōnðes	11 février
11. Gēolmōnþes	11 décembre
12. Gēolmōnðes	12 décembre
17. Gēolmōnðes	17 décembre
Wæþ	Forth (fleuve)
Þrittiggēara Orlege	Guerre de Trente Ans
Benedictus XVI Pāpa	Benoît XVI
6. Ēastermōnðes	6 avril
4. Ēastermōnþes	4 avril
Helmut Kohl	Helmut Kohl
17. Ēastermōnðes	17 avril
12. Þrimilcemōnþes	12 mai
13. Þrimilcemōnþes	13 mai
20. Þrimilcemōnðes	20 mai
31 Þrimilcemōnaþ	31 mai
6. Mǣdmōnðes	6 juillet
1. Mǣdmōnðes	1er juillet
18. Mǣdmōnðes	18 juillet
Gyldfōtþōðer	Football
26. Gēolmōnðes	26 décembre
Eallbærnet	Shoah
IPad	IPad
Madrid	Madrid
Elton John	Elton John
Undersǣbāt	Sous-marin
26. Wēodmōnðes	26 août
24. Wēodmōnðes	24 août
2. Hāligmōnþes	2 septembre
Kassel	Cassel (Hesse)
Canadisc underrīcu	Provinces et territoires du Canada
25. Hāligmōnðes	25 septembre
Santiago (Cile)	Santiago
1. Winterfylleðes	1er octobre
14. Winterfylleðes	14 octobre
8. Winterfylleðes	8 octobre
7. Winterfylleðes	7 octobre
Oldenburg (Oldenburg)	Oldenbourg
26. Winterfylleðes	26 octobre
4. Blōtmōnðes	4 novembre
1. Blōtmōnðes	1er novembre
Wolfsburg	Wolfsbourg
Carl Micela Francena Cyning	Charlemagne
Canberra	Canberra
Sydney	Sydney
Grēne	Vert
Rēad	Rouge
Perþ (Australia)	Perth (Australie-Occidentale)
Fȳr	Feu
Westerne Australia	Australie-Occidentale
Nīwe Sūþwealas	Nouvelle-Galles du Sud
Norþerne Landscipe	Territoire du Nord
Australisc Hēafodbyrig Landscipe	Territoire de la capitale australienne
Fīfeldor	Eider (fleuve)
Nīl	Nil
Heortfordscīr	Hertfordshire
Comēta	Comète
Angol	Angol
Antofagasta	Antofagasta
Ancyra	Ankara
Flocc:Bysen	Catégorie:Espace Modèle
Castro (Cile)	Castro (Chili)
Frencisc Guiana	Guyane
Chillán (Cile)	Chillán
Amāzanēa	Amazone (fleuve)
Tybingen	Tübingen
Coyhaique	Coyhaique
Flocc:Bysen Land	Catégorie:Modèle par pays
Willelmeshæfen	Wilhelmshaven
Copiapó (Cile)	Copiapó
Manama	Manama
Delmenhorst	Delmenhorst
Brandenburg (burg)	Brandebourg-sur-la-Havel
Wikipǣdia:Sandbox	Wikipédia:Bac à sable
Wikipǣdia:Inlǣdung	Aide:Premiers pas
Cantabria	Cantabrie
Hūs	Maison
Rīmagiefung	Algèbre
Mennisc bodiglār	Anatomie humaine
Osasco	Osasco (Brésil)
Fujairah	Fujaïrah (émirat)
Glasgow	Glasgow
Donghoi Lyfthæfene	Aéroport de Đồng Hới
Rodor	Espace (cosmologie)
Sweartweald	Forêt-Noire
Curitiba	Curitiba
Weald	Forêt
Flocc:Cliferfētedēor	Catégorie:Artiodactyla
Talca	Talca
Flothere	Marine de guerre
Andalién	Río Andalién
Bysen:Lang-lt	Modèle:Lang-lt
Cwidbōc	Livre des Proverbes
Rancagua	Rancagua
Confucius	Confucius
Corbin Bleu	Corbin Bleu
Flocc:Rīmcræft	Catégorie:Mathématiques
Faroisca Īega	Îles Féroé
Wendelsǣ	Mer Méditerranée
Flocc:Nīwes Sǣlandes īga	Catégorie:Île de Nouvelle-Zélande
Cōcnearuness	Détroit de Cook
Crīstendōm	Christianisme
Windows 8	Windows 8
Bysen:Asia	Modèle:Palette Pays d'Asie
Gandis	Gange
Worulddǣl	Continent
Fugol	Oiseau
Hēafodstōl	Capitale
Monzón	Monzón
Portuglisc sprǣc	Portugais
Mōnaþ	Mois
Almazán	Almazán
Huang Siānfan	Huang Xianfan
Kescwisc sprǣccynn	Quechua
Bill Gates	Bill Gates
Iapanisc sprǣc	Japonais
Wīsdōmbōc	Encyclopédie
Hēafodtramet	Wikipédia:Accueil principal
Golf	Golf
Hrōcburhfōtþōðer	Rugby (sport)
Olympisc Gamen	Jeux olympiques
Eurasia	Eurasie
Andes	Cordillère des Andes
Durban	Durban
Caspia	Mer Caspienne
Uictoriamere	Lac Victoria
Estmere	Lagune de la Vistule
Babilōn	Babylone
Ēalendisca Īega	Åland
Cægman Īegland	Îles Caïmans
Novak Đoković	Novak Djokovic
Fortunatus iegland	Îles Canaries
Hrōcburhgesamnunge plega	Rugby à XV
Ūðwitegung	Philosophie
Flocc:Candidates for speedy deletion	Catégorie:Wikipédia:Suppression immédiate demandée
Tē	Thé
Hebe Camargo	Hebe Camargo
Gemǣnre ǣhte rǣd	Communisme
Wealdlīste rǣd	Anarchisme
Ǣhtwealdes endebyrdness	Capitalisme
Frēodōmes þōht	Libéralisme
Gilmrǣd	Fascisme
Cofentreo	Coventry
Lodi	Lodi
Ōðre Penisc Gūþ	Deuxième Guerre punique
Cartaina	Carthage
Bryttisc Museum	British Museum
Sund	Natation
1451	1451
Ellaspontus	Détroit des Dardanelles
Strǣtburg	Strasbourg
Gytārre	Guitare
Croatisc sprǣc	Croate
Cesena	Cesena
Hāmburgere	Hamburger
Fédération Internationale de Volleyball	Fédération internationale de volley-ball
20e gēarhundred	XXe siècle
Stefan Raab	Stefan Raab
Catalan sprǣc	Catalan
11e gēarhundred	XIe siècle
Gelēaflēasnes	Athéisme
Cynn scī huang	Qin Shi Huang
Elisabeþ I Engla Cwēn	Élisabeth Ire (reine d'Angleterre)
Cynewīse	République
Þēodlices gemǣnscipes rǣd	Nazisme
Nazi Þēodscland	Troisième Reich
Christopher Columbus	Christophe Colomb
Iacobus Cōc	James Cook
Ēare	Oreille
Nasu	Nez
Ēage	Œil
Scēap	Mouton
Mereswīn	Dauphin
Sǣhund	Requin
Sycedēor	Mammifère
Ǣmette	Fourmi
Bēo	Abeille
Niðerlendisc sprǣc	Néerlandais
Ǣȝƿyrt	Aubergine
Draca	Dragon (mythologie)
Mōdor	Mère
Snāw	Neige
Wæterþōðer	Water-polo
1865	1865
Napoleon III Francena Casere	Napoléon III
Russisc sprǣc	Russe
Hloþwig XIV Francena Cyning	Louis XIV
Hām	Domicile
Vladimir Putin	Vladimir Poutine
Loðwic-Philippus Francena Cyning	Louis-Philippe Ier
Þēodacynewīse	Commonwealth of Nations
Hlāf	Pain
Taurica	Crimée
Līfclēofa	Cellule (biologie)
Blōd	Sang
Īwungplega	Jeu vidéo
Rumǣnisc sprǣc	Roumain
Regn	Pluie
Medumweder	Climat
Woruldlicu wearmung	Réchauffement climatique
Eorþbeofung	Séisme
Museum on Dēoraby	Derby Museum and Art Gallery
Winston Churchill	Winston Churchill
Nelson Mandela	Nelson Mandela
10. gēarhundred	Xe siècle
Fȳrbeorg	Volcan
Wolcen	Nuage
Īwungplegtōl	Console de jeux vidéo
Wind	Vent
Lyfthelm	Atmosphère (astronomie)
Pintel	Pénis humain
Sprǣccræft	Linguistique
Flocc:Pulgaraland	Catégorie:Bulgarie
Flocc:Francland	Catégorie:France
Flocc:Glīƿdrēam	Catégorie:Musique
Flocc:Bōccræft	Catégorie:Littérature
Fox	Renard roux
Hræfn	Corbeau
Valladolid	Valladolid
Alexander Mæcedonia Cyning	Alexandre le Grand
Hēaphandþōðer	Handball
Hugo Chávez	Hugo Chávez
Þēowdōm	Esclavage
Caffig	Café
Meolc	Lait
Beorg	Montagne
Oferswefn	Hypnose
Andrew Johnson	Andrew Johnson
Miami	Miami
Americanisce Ingefeoht	Guerre de Sécession
Rio de Janeiro	Rio de Janeiro
Bryttisce Rīce	Empire britannique
Albanisc sprǣc	Albanais
Ucrægnisc sprǣc	Ukrainien
Crabba (steorra)	Cancer (constellation)
Swēonisc sprǣc	Suédois
Denisc sprǣc	Danois
Norðisc sprǣc	Norvégien
Noam Chomsky	Noam Chomsky
Bæmisc sprǣc	Tchèque
Karl Marx	Karl Marx
Lettisc sprǣc	Letton
Liþþuanisc sprǣc	Lituanien
Hinduismus	Hindouisme
Wīflicu brēost	Sein
Mot	Atome
Crēacisc sprǣc	Grec
Weorcendebyrdness	Système d'exploitation
Īrisc sprǣc	Irlandais
Ambihtlic Cīnisc sprǣc/ᚱᚢᚾ	Mandarin (langue)
C. S. Lewis	C. S. Lewis
Baku	Bakou
Hebrēisc sprǣc	Hébreu
Azeri sprǣc	Azéri
Wilisc sprǣc	Gallois
Scyttisce sprǣc	Gaélique écossais
John Locke	John Locke
Friedrich Nietzsche	Friedrich Nietzsche
Lifere	Foie
Drēag (Fūdū)	Zombie (mort-vivant)
Gārsecg	Océan
Gautama Budda	Siddhartha Gautama
Premier League	Championnat d'Angleterre de football
Mahomet	Mahomet
Ācweorna	Sciuridae
Rēmisc Cirice	Église catholique
Bengalisc sprǣc	Bengali
Tunge	Langue (anatomie humaine)
Folcland Īegland	Îles Malouines
Manīeg	Île de Man
Wiht (īeg)	Île de Wight
Heortford	Hertford
Elisabeþ II	Élisabeth II
ß	Eszett
John F. Kennedy	John Fitzgerald Kennedy
Ronald Reagan	Ronald Reagan
Æ	Æ
Ð	Eth (lettre)
Fernando Alonso	Fernando Alonso
Flocc:Feneswela	Catégorie:Venezuela
Þunreshæfen	Tórshavn
11. Hāligmōnþes 2001. torngemōt	Attentats du 11 septembre 2001
Culfre	Columbidae
Trēow	Arbre
Cīese	Fromage
Wīnberge	Raisin
Hunig	Miel
Eorþperu	Pomme de terre
Searuþræl	Robot
Searucræft	Technologie
Feorrspreca	Téléphone
Lugo	Lugo (Espagne)
Hēahdēmere þāra Geāndena Rīca American	Juge en chef des États-Unis
Windows 7	Windows 7
Windows Vista	Windows Vista
World Trade Center	World Trade Center
Nelson Rockefeller	Nelson Rockefeller
David Rockefeller	David Rockefeller
One World Trade Center	One World Trade Center
Fidel Castro	Fidel Castro
Rockefeller Center	Rockefeller Center
Flocc:Brasil	Catégorie:Brésil
Flocc:Rumǣnia	Catégorie:Roumanie
Hēafodgesceaft	Élément chimique
Gemot	Molécule
Cræftlicu endebyrdung	Classification scientifique des espèces
Lyft	Gaz
Lyftcræft	Aéronef
Clāðas	Vêtement
Swēg	Son (physique)
Paper	Papier
Rīm	Nombre
Bere	Orge commune
Nirvana	Nirvana (groupe)
Weder	Temps (météorologie)
Land þǣre worulde	Liste des pays du monde
Bera	Ursidae
John Adams	John Adams (homme politique)
Thomas Jefferson	Thomas Jefferson
James Madison	James Madison
James Monroe	James Monroe
John Quincy Adams	John Quincy Adams
Andrew Jackson	Andrew Jackson
Martin Van Buren	Martin Van Buren
William Henry Harrison	William Henry Harrison
John Tyler	John Tyler
James K. Polk	James Knox Polk
Zachary Taylor	Zachary Taylor
Ǣtweg	Digestion
Kylie Minogue	Kylie Minogue
Āc	Chêne
Pīntrēow	Pin (plante)
Āte	Avoine cultivée
Hwǣte	Blé
Corn	Céréale
Unmeaht	Handicap
Gerīmbōc	Calendrier
Ādl	Maladie
Gregorisc gerīmbōc	Calendrier grégorien
Soria	Soria
Manisc sprǣc	Mannois
Bysen:Stedefindend scite Breten	Modèle:Géolocalisation/Royaume-Uni
Millard Fillmore	Millard Fillmore
Franklin Pierce	Franklin Pierce
James Buchanan	James Buchanan
Pireni	Pyrénées
Hālig Rōmānisc Rīce	Saint-Empire romain germanique
Mongolrīce	Empire mongol
Oþomanisce Rīce	Empire ottoman
Cirice Ednīwung	Réforme protestante
Wīcingas	Vikings
Sweord	Épée
Fȳrwǣpen	Arme à feu
Iberia	Péninsule Ibérique
Fȳrspringend	Explosif
Campwægn	Char de combat
Antwerpen	Anvers
Brycg (burh)	Bruges
Blǣwenberge	Bleuet (fruit)
Blæcberige	Mûre (fruit de la ronce)
Fenberge	Canneberge
Cīnisc gōsberige	Kiwi
Retoromanisc sprǣc	Romanche
Īsrēam	Crème glacée
Ceace	Gâteau
Īsbrīw	Sorbet
Dinegisc sprǣc	Navajo (langue)
Meolcbrīw	Yaourt
Montserrat	Montserrat (Antilles)
Bysen:Location map Greenland	Modèle:Géolocalisation/Groenland
Wikicynn	Wikispecies
Arabisc sprǣc	Arabe
Ian Magen	Île Jan Mayen
Corsica	Corse
Affricanisc sprǣc	Afrikaans
Forma Þegn þæs Geānedan Cynerīces	Premier ministre du Royaume-Uni
Santiago de Compostela	Saint-Jacques-de-Compostelle
Fiscoþ	Pêche (halieutique)
Iquique	Iquique
La Serena (Cile)	La Serena
Las Condes	Las Condes
Lebu	Lebu
Lo Barnechea	Lo Barnechea
Niðerscyttisc sprǣc	Scots
Linux (cyrnel)	Noyau Linux
Darwin (æhtendebyrd)	Darwin (informatique)
Emmen	Emmen (Drenthe)
Sofiet Gesamnung	Union des républiques socialistes soviétiques
Se Hlāford þāra Hringa	Le Seigneur des anneaux
Hrūse	Croûte terrestre
Sīensearu	Appareil photographique
Gaðes	Cadix
Llión	León (Espagne)
Fōt	Pied (anatomie humaine)
Queen	Queen
Freddie Mercury	Freddie Mercury
Normandig	Normandie
Metallica	Metallica
Wikipǣdia:Fulgōd gewritu	Wikipédia:Articles de qualité
Lēoht (dæg)	Lumière du jour
Wikipǣdia:Se Þorpes Wella	Wikipédia:Le Bistro
Vermont	Vermont
Jacksonville, Florida	Jacksonville (Floride)
Los Ángeles (Cile)	Los Ángeles
Eþna	Etna
Æg	Œuf (biologie)
Tibet	Tibet
Handsprecend	Téléphone mobile
Strȳta	Autruche d'Afrique
Corēa	Corée
Wesend	Bison
Mameceaster	Manchester
Turcas and Caicos Īegland	Îles Turques-et-Caïques
Blēocræft	Broderie
Wulf	Canis lupus
Major League Soccer	Major League Soccer
Þōðer	Ballon (sport)
Club de Gimnasia y Esgrima La Plata	Club de Gimnasia y Esgrima La Plata
Nīwu Gecȳþnes	Nouveau Testament
Ælfric Ercebiscop of Cantawarabyrig	Ælfric d'Abingdon
Middelseaxe	Middlesex
San Pedro de la Paz	San Pedro de la Paz
Scræf (fugol)	Phalacrocorax
Dūfedoppa	Pélican
Nha Trang	Nha Trang
Podolsk	Podolsk
Pāpa	Pape
Rafael Correa	Rafael Correa
5	5
Louvre	Musée du Louvre
Sæfern	Severn
Temes	Tamise
Tirana	Tirana
Motorhead	Motörhead
Afen	Avon (Bristol)
6	6
Josh Duhamel	Josh Duhamel
Stīðen Āc	Stevenage
Crīstesmæsse	Noël
Bises	Année bissextile
Steve Jobs	Steve Jobs
Indo-Europisc sprǣchīred	Langues indo-européennes
Breinigerberg	Breinigerberg
Muammar al-Gaddafi	Mouammar Kadhafi
Tiger	Tigre
Moru	Légume-racine
Samsunghēap	Groupe Samsung
Ēaster	Pâques
Germanisca sprǣca	Langues germaniques
Windows Mobile	Windows Mobile
GNU Frēo Gewrita Amearcunge Lēaf	Licence de documentation libre GNU
John Kerry	John Kerry
Taiwan (īeg)	Taïwan (île)
Searusprecend	Smartphone
Trōia	Troie
Nīwe Eoforwīc (scīrung)	New York (homonymie)
Ceafer	Coleoptera
Scōh	Chaussure
Baðanceaster	Bath
Īrland	Irlande (île)
Bradanford	Bradford
Ceasterscīr	Cheshire (comté)
Lonceasterscīr	Lancashire
Norþhymbraland	Northumberland (comté)
Dūnholmscīr	Durham (comté)
Lincolnscīr	Lincolnshire
Snotingahāmscīr	Nottinghamshire
Dēorabyscīr	Derbyshire
Scrobbesbyrigscīr	Shropshire
Stæffordscīr	Staffordshire
Lægreceastrescīr	Leicestershire
Roteland	Rutland
Norþfolc	Norfolk (comté)
Sūþfolc	Suffolk
Grantabrycgscīr	Cambridgeshire
Norþhāmtūnescīr	Northamptonshire
Westmidlandscīr	Midlands de l'Ouest (comté)
Herefordscīr	Herefordshire
Wigreceastrescīr	Worcestershire
Wæringscīr	Warwickshire
Beadanfordscīr	Bedfordshire
Cornweal	Cornouailles
Bricgstōw	Bristol (Angleterre)
Defenascīr	Devon (comté)
Sumorsǣte	Somerset
Dorsǣte	Dorset (comté)
Gleawcesterscīr	Gloucestershire
Oxnafordscīr	Oxfordshire
Wiltūnscīr	Wiltshire
Hāmtūnescīr	Hampshire (comté)
Bearrucscīr	Berkshire
Buccingahāmscīr	Buckinghamshire
Ēastseaxe	Essex (comté)
Sūþrīge	Surrey (comté)
Cent	Kent
Lundenceaster	Cité de Londres
Westmoringaland	Westmorland
Huntandūnscīr	Huntingdonshire
Sūþseaxe	Sussex
Seofon	7 (nombre)
Taylor Lautner	Taylor Lautner
Cumbraland	Cumberland (comté)
Jeremy Renner	Jeremy Renner
Īs	Glace
Fæder ūre	Notre Père
Musée d'Orsay	Musée d'Orsay
Hwerhwette	Concombre
Edinburg	Édimbourg
Hwīt	Blanc
Sweart	Noir
Chris Pine	Chris Pine
Lordi	Lordi
6 (getæl)	6 (nombre)
Ambihtlicu sprǣc	Langue officielle
Heortæppel	Tomate
Phong Nha-Ke Bang	Parc national de Phong Nha-Kẻ Bàng
Entrena	Entrena
Selena	Selena
NASA	National Aeronautics and Space Administration
Merida (Feneswela)	Mérida (Venezuela)
Atlanta	Atlanta
Benito Mussolini	Benito Mussolini
Bermuda	Bermudes
Hēafod	Tête (anatomie)
Weolingtūn (Nīwe Sǣland)	Wellington
Bryten	Grande-Bretagne
Alfred Nobel	Alfred Nobel
Camb (tō hǣre)	Peigne
Mennisc līc	Corps humain
Lila Downs	Lila Downs
Andrew Garfield	Andrew Garfield
Dottatiger	Guépard
Rosanna Davison	Rosanna Davison
Albany on Nīwum Eoforwīce	Albany (New York)
Ūle	Strigiformes
Anguilla	Anguilla
Guernsey	Guernesey
Scearpbeorgas	Svalbard
Hrycgdēor	Vertébrés
Nowy Dwór Królewski	Nowy Dwór Królewski
Faroisc sprǣc	Féroïen
Catt	Felidae
Lytel Spēonland	Hispaniola
Harrisburg	Harrisburg
Hamor	Marteau (outil)
Picilemo	Pichilemu
Bryttiscan Fæmne Īegland	Îles Vierges britanniques
Flēoge	Diptera
Norða	Arctique
Hund	Canidae
Fresisc sprǣc	Frison (langue)
Antoni Gaudí	Antoni Gaudí
Cliferfētedēor	Artiodactyla
Steorrfisc	Étoile de mer
Eurasisc bleohcrāwe	Geai des chênes
Hrōc	Corbeau freux
Ēotaland	Jutland
Niþeru Þēodsc sprǣc	Bas allemand
Mölnlycke	Mölnlycke
Coning	Oryctolagus cuniculus
Cuscan Rīce	Empire kouchan
Tromsīeg	Tromsø
Sandwīc	Sandwich (Kent)
Eormengyld Niccolò Cusano	Université Nicolas-de-Cues
Montpelier on Uermonte	Montpelier
Geac	Yak
Palistiniscre Frēogunge Þēodnes	Organisation de libération de la Palestine
Westgermanisca sprǣca	Langues germaniques occidentales
Taylor Swift	Taylor Swift
Cōcīega	Îles Cook
Brocc	Blaireau européen
Sealterisc sprǣc	Frison oriental
Middelasia	Asie centrale
Langaland	Langeland
Sealterland	Saterland
Ofersǣwisc rind	Cannelle (écorce)
Jackson (Mississippi)	Jackson (Mississippi)
Concord (Nīwu Hāmtūnscīr)	Concord (New Hampshire)
Annapolis	Annapolis
Eald Corēa	Période Gojoseon
Hreaðemūs	Chiroptera
Ēastrīce-Ungerland	Autriche-Hongrie
Tarnobrzeg	Tarnobrzeg
Wesle	Mustela
Scīr	Comitat
Sandwīc (ǣt)	Sandwich
Spearwa	Passeridae
Eormanrīc	Ermanaric
Francisco Franco	Francisco Franco
Tarja Halonen	Tarja Halonen
Willis Tower	Willis Tower
Cantwaraburg	Canterbury
Cīna	Monde chinois
Universidad Mayor	Université Mayor
Tracter	Entonnoir
Englisc lagu	Common law
Seolh	Pinnipède
Ecser	Ecser
Silesisc gereord	Silésien (langue slave)
Zhengzhou	Zhengzhou
Foresittend	Président
Frencisc Polynesia	Polynésie française
Roðem	Rouen
Crīstesmæsse Īeg	Île Christmas (Australie)
Bleohfugol	Psittaciformes
Cambihtere	Cacatuidae
Arabea	Arabie
Fȳstlāc	Boxe anglaise
Seax	Couteau
Top Gear	Top Gear
Tasmansǣ	Mer de Tasman
Ceroke sprǣc	Cherokee (langue)
Campwīg be Tannebeorge	Bataille de Grunwald
Īsbera	Ours blanc
Hand	Main
Tu Fu	Du Fu
Nīwe Scotta Ēaland	Nouvelle-Calédonie
Cecoslofacia	Tchécoslovaquie
Lēaf	Feuille
Nepal Bhasa	Nepalbhasha
Valparaíso (on Cilan)	Valparaiso
Fugolīeg, Sūþgeorgia	Île Bird
Annenkovīeg	Île Annenkov
Nathalia Dill	Nathalia Dill
Oaxaca	État de Oaxaca
Tahitisc sprǣc	Tahitien
Flemisc sprǣc	Flamand (dialecte)
Yasser Arafat	Yasser Arafat
Oxnaford	Oxford
Międzyrzec Podlaski	Międzyrzec Podlaski
Tasmania	Tasmanie
Creto	Crète
Saint-Dié-des-Vosges	Saint-Dié-des-Vosges
Eormengyld Oxnafordes	Université d'Oxford
Þyrla	Hélicoptère
Sancte Elene Īeg	Sainte-Hélène (île)
Nicor	Hippopotamus amphibius
Egisca Sǣ	Mer Égée
Ichiro Mizuki	Ichirō Mizuki
Anastacia	Anastacia
Eufrāte	Euphrate
James A. Garfield	James Abram Garfield
Cirice	Église (institution)
Persisc Sǣ	Golfe Persique
Sand	Sable
Cyningestūn (Iamaica)	Kingston (Jamaïque)
Lafor	Léopard
Age of Empires	Age of Empires (série)
Tequixquiac	Tequixquiac
Ulysses S. Grant	Ulysses S. Grant
Oklahoma City	Oklahoma City
Meotedisca Mere	Mer d'Azov
William McKinley	William McKinley
Cawel	Chou cabus
Foresittend þāra Geāndena Rīca	Liste des présidents des États-Unis
Sūþgeorgia and þā Sūþsandwic Īegland	Géorgie du Sud-et-les Îles Sandwich du Sud
Webbsīde	Site web
Ealdfresisc sprǣc	Vieux frison
Catalão	Catalão
Grover Cleveland	Grover Cleveland
Ealdhēahþēodisc	Vieux haut-allemand
Ealdseaxisc sprǣc	Vieux saxon
Satan	Satan
Wordstǣrcræft	Étymologie
Beorglēo	Puma
Arabas	Arabes
Proponditis	Mer de Marmara
Ēagduru	Fenêtre
Chester A. Arthur	Chester Alan Arthur
Riffeng	Oural
Rīcu þāra Geāndena Rīca American	États des États-Unis
Pitcearnīega	Îles Pitcairn
Benjamin Harrison	Benjamin Harrison
Rutherford B. Hayes	Rutherford Birchard Hayes
Wīnlendisc panðer	Jaguar
Sūþaustralia	Australie-Méridionale
Gotisc sprǣc	Gotique
Boise	Boise
Bāt	Bateau
Awaisc sprǣc	Guarani (langue)
Gærsbēam	Bambou
Interlingua	Interlingua (IALA)
Bosporos	Bosphore
Smyrna	Izmir
Lemburg	Lviv
Cwēneland	Queensland
Siligo	Siligo
Puerto Montt	Puerto Montt
Iane Austen	Jane Austen
Tægcwondo	Taekwondo
Middel Englisc sprǣc	Moyen anglais
Māorisc sprǣc	Maori de Nouvelle-Zélande
Hannibal	Hannibal Barca
Hōrdōm	Prostitution
Twinemniendlic nama	Nom binominal
Victoria (Australia)	Victoria (État)
Geugoslafia	Yougoslavie
Ætla	Attila
Scrælingas	Amérindiens
Arancón	Arancón
Willelm Heretoga of Grantanbrycge	William de Cambridge
Toshiro Mifune	Toshirō Mifune
Tallahassee	Tallahassee
Sundorrīcehād	Indépendance (politique)
Bismarck (Norþdakota)	Bismarck (Dakota du Nord)
Aucland	Auckland
Iohannes Paulus I Pāpa	Jean-Paul Ier
John Michael Talbot	John Michael Talbot
Acrotiri and Ðecelia	Akrotiri et Dhekelia
Arara	Arara
Cnēo	Genou
Willelm I Engla Cyning	Guillaume le Conquérant
Campora Sancte Iohannes	Campora San Giovanni
Sīde	Soie
Sint-Truiden	Saint-Trond
Lēoðlic scātung	Patinage artistique
Stefn (līfcræft)	Embranchement (biologie)
Heanrig VIII Engla Cyning	Henri VIII
Columbia (Sūþcarolīna)	Columbia (Caroline du Sud)
Xena: Warrior Princess	Xena, la guerrière
1880. gēar oþ 1889. gēar	Années 1880
Helena (Montana)	Helena (Montana)
Wælhwelp	Chien de chasse
Eormengyld Biobiwes	Université du Bío-Bío
Sufa	Suva
Muntgumniscīr	Montgomeryshire
Eorþmistel	Basilic (plante)
Lēohtfȳsend	Laser
Prēossland	Prusse
Cheyenne (Wyoming)	Cheyenne (Wyoming)
Norðerne healftrendel	Hémisphère nord
Loidis	Leeds
Fūcgī Beorg	Mont Fuji
Mūs	Mus (genre)
Geolurēad	Orange (couleur)
Æcs	Hache
Seofonbyrig	Transylvanie (région)
Tōl	Outil
Alī	Ali ibn Abi Talib
Hrān	Rangifer tarandus
Stānhencg	Stonehenge
Ágreda	Ágreda
Amazonas	Amazonas (Brésil)
Ajaccio	Ajaccio
Rodorcræft	Véhicule spatial
Lisa Gerrard	Lisa Gerrard
Thirty Seconds to Mars	Thirty Seconds to Mars
Paulínia	Paulinia
Pierre	Pierre (Dakota du Sud)
Crabba	Brachyura
God Nerie þā Cwēne	God Save the Queen
Meteūtsiht	Diarrhée
Anna Maria Jopek	Anna Maria Jopek
Horshwæl	Morse (animal)
Fōrhēafod	Front (anatomie)
Haile Selassie	Haïlé Sélassié Ier
Caðum	Caen
Sonygegyld	Sony
Mynet	Pièce de monnaie
Sūðerne Healftrendel	Hémisphère sud
Cnihtas þæm Temple	Ordre du Temple
Americanisc fōtball	Football américain
Tōþsticca	Cure-dent
Folcmorðor	Génocide
Hociȝ	Hockey sur glace
Swīnmūþa	Świnoujście
Īrisc Sǣ	Mer d'Irlande
Tracia	Thrace
Mongolas	Mongols
Mǣs	Meuse (fleuve)
Talcahuano	Talcahuano
Tahitīeg	Tahiti
Ontynung	Apocalypse
Abel Tasman	Abel Tasman
Gotan	Goths
Nettfrumfindend	Uniform Resource Locator
Ænglisc sprǣc	Vieil anglais
Englisc folc	Anglais (peuple)
Eoforwic	York
Iron Maiden	Iron Maiden
Asterix	Astérix
Grǣg	Gris
Wearm geard	Tropique
Hwælhuntoþ	Chasse à la baleine
Sǣcū	Lamantin
Gregorius Pāpa I	Grégoire Ier
Cȳta (lyftcræft)	Cerf-volant
Þunor	Thor
Castel Goffredo	Castel Goffredo
Roðos	Rhodes
Sanct	Saint
Wikipǣdia:FAQ	Aide:FAQ
Galatasaray	Galatasaray Spor Kulübü
Cycene	Cuisine (pièce)
Wæterdraca	Crocodylidae
Hlæstwægn	Camion
Carl Wēala Þēoden	Charles de Galles
Villeneuve-d'Ascq	Villeneuve-d'Ascq
Crāwe	Corvus
Sūþtun on Defnum	Plymouth (Angleterre)
Bryttisca Indisca Garsecg Landscipe	Territoire britannique de l'océan Indien
Dēoraby	Derby (Angleterre)
Francan	Francs
Fealcen	Faucon
Nightwish	Nightwish
Mattheus se Godspellere	Matthieu (apôtre)
Mac OS	Mac OS
Leyden	Leyde
Montehermoso	Montehermoso
Louis the Pious	Louis le Pieux
Cwēnsǣ	Mer Blanche
Jim Morrison	Jim Morrison
GNOME	GNOME
Hāt	Chaleur (sensation)
Spere	Lance
Ēadig getæl	Nombre heureux
Charleston (Westvirginia)	Charleston (Virginie-Occidentale)
Mynster	Monastère
Oxnaford Englisc Wordbōc	Oxford English Dictionary
Īsearn	Alcedinidae
Carl XVI Gustaf Swēona Cyning	Charles XVI Gustave
Świętochłowice	Świętochłowice
Nile	Nile
Zac Efron	Zac Efron
Monte Carlo	Monte-Carlo
Elba	Île d'Elbe
The Doors	The Doors
Fylfōt	Svastika
Clerke Clūdas	Clerke Rocks
Hara	Lièvre
Rīcisc edisc	Parc national
Boga	Arc (arme)
Byrdling	Testudinidae
Bryttisc landbūnes	Territoire britannique d'outre-mer
Brūn	Brun (couleur)
Hjaltland	Shetland
Byrddæg	Anniversaire
Æx-in-Profentse	Aix-en-Provence
Gaza	Gaza
Īsbeorg	Iceberg
Ephese	Éphèse
Englisc wera rīcisc fōtballtēam	Équipe d'Angleterre de football
Pratibha Patil	Pratibha Patil
Minte	Menthe
Spilcarte	Carte à jouer
Bysen:Commonscat	Modèle:Commonscat
Hālig Land	Terre sainte
Folcland Gewinn	Guerre des Malouines
Beadu be Culme	Bataille de Kulm
Bēowulf	Beowulf
Marīahæfen	Mariehamn
Hrǣw	Cadavre
IOS	IOS (Apple)
Lee Harvey Oswald	Lee Harvey Oswald
Frumtæl	Nombre premier
Þ	Þ
Orlando	Orlando (Floride)
Saint Petersburg	St. Petersburg
Hereðaland	Comté de Hordaland
Sogn and þa Flēotas	Comté de Sogn og Fjordane
Meore and Romsdæl	Comté de Møre og Romsdal
Troms	Comté de Troms
Dǣlere	Diviseur
Australisc fōtþōðer	Football australien
Secglēac	Ciboulette (botanique)
Stānweall sacunga	Émeutes de Stonewall
Providencia (Cile)	Providencia (Chili)
Punta Arenas	Punta Arenas
Aaron	Aaron (Bible)
Wu-Tang Clan	Wu-Tang Clan
Osgar I Swēona Cyning	Oscar Ier
Hwēolrinnung	Cyclisme
Aquilegia	Aquilée
Hyll	Colline
Flocc:Cyningas	Catégorie:Roi
Beorneslēah	Barnsley
Banff	Banff (Écosse)
Soria (scīr)	Province de Soria
San Carlos (on Cilan)	San Carlos (Chili)
Harold V Norrena Cyning	Harald V
Þēodlic Dæg	Fête nationale
John Key	John Key
Ēadweard I Engla Cyning	Édouard Ier (roi d'Angleterre)
Ræt	Muroidea
Vladimír Franz	Vladimír Franz
Ariel Sharon	Ariel Sharon
1050e	Années 1050
Æneid	Énéide
Autaugaville, Alabama	Autaugaville
Forma Frencisce Rīce	Premier Empire
Brādford	Bredevoort
Se Holbytla	Le Hobbit
Eocene	Éocène
Hwilpe	Courlis à long bec
Strǣt	Rue
Superman	Superman
Heorotbrēr	Nerprun
Wikipǣdia:Fulgōdra gewrita teohhunga	Wikipédia:Articles de qualité/Propositions
Wikipǣdia:Gōd gewrit genamunga	Wikipédia:Bons articles/Propositions
Rætswīn	Cavia porcellus
Iconium	Konya
Emma Goldman	Emma Goldman
Iacobus I Grēatre Bryten Cyning	Jacques VI et Ier
Crīstcirice	Christchurch
Coronel Fabriciano	Coronel Fabriciano
Babsk	Babsk
Englisca Ingewinn	Première Révolution anglaise
Bengal	Bengale
Morgenmete	Déjeuner
1060e	Années 1060
Pippen III Francena Cyning	Pépin le Bref
Carl I (Grēatre Bryten Cyning)	Charles Ier (roi d'Angleterre)
Ȝealdor/ᚷᛖᚪᛚᛞᚩᚱ	Magie (surnaturel)
Cucler	Cuillère
Geþofted Rīcu American	États confédérés d'Amérique
Elpendbān	Ivoire
Villarrobledo	Villarrobledo
Temuco	Temuco
Hloðwic I Francena Cyning	Clovis Ier
William Wallace	William Wallace
Bundesliga	Championnat d'Allemagne de football
Fȳrland	Terre de Feu
Frēols þǣre Sunnan (on Meridan)	Feria del Sol (Mérida)
Maria I Engla Cwēn	Marie Ire (reine d'Angleterre)
Angelcirice	Église d'Angleterre
Engla Cyning	Liste des monarques d'Angleterre
Lencten (tīd)	Carême
Fuþorc	Rune
Lēactric	Laitue cultivée
Beadu Hǣstingum	Bataille d'Hastings
Ēadweard VI Engla Cyning	Édouard VI
Jacques-Yves Cousteau	Jacques-Yves Cousteau
Horatio Nelson	Horatio Nelson
Galilēa	Galilée (région)
Gaderscypefāna	Drapeau du Royaume-Uni
Foldlic clūt	Lithosphère
Þunor (weder)	Tonnerre
Þūma	Pouce (anatomie)
Ælfrēd Micela	Alfred le Grand
Hāmlǣrung	Instruction à domicile
Teutoburg Weald Beadu	Bataille de Teutobourg
Bysen:Cite book	Modèle:Ouvrage
O Canada	Ô Canada
Biobío	Río Biobío
Orcanege	Orcades
Profentse	Provence
Predore	Predore
Seaxe	Saxons
Willelm II Engla Cyning	Guillaume le Roux
Limburgisc	Limbourgeois
Eallerīca Gotena Cyning	Alaric Ier
Tygelwīg	Tir à la corde
Boētius	Boèce
Hunigbēo	Apis (genre)
Abbod	Abbé
Mæcedonia	Macédoine (région)
Sameramis	Sémiramis
Pīp	Pipe
Aerosol	Aérosol
Gangnihessou	Gangnihessou
Ilfingburg	Elbląg
Mierce	Mercie
Þēodrīc Ēastgotena Cyning	Théodoric le Grand
Westseaxena Rīce	Wessex
Hēahland	Highlands
Norþhymbra Rīce	Northumbrie
Wulfila	Wulfila
Bram Stoker's Dracula	Dracula (film, 1992)
Angeow	Anjou
2011 FIFA Frēona Woruldceampscipe	Coupe du monde de football féminin 2011
Alexander VI Pāpa	Alexandre VI
Æppellēaf	Violette odorante
Edward Braddock	Edward Braddock
Cethāmīga	Îles Chatham
Norþīg	Île du Nord
Anne Cwēn	Anne (reine de Grande-Bretagne)
Sūþīeg	Île du Sud
Husvik	Husvik
Dziecinów	Dziecinów (Otwock)
Sunnstede	Solstice
Wynton Rufer	Wynton Rufer
Regnwyrm	Lumbricina
Kara	Kara (groupe)
Ceadmere	Lac Tchad
Getalu Rōmāniscra Cāsera	Liste des empereurs romains
Heantun	Wolverhampton
Wascas	Basques
Minerva	Minerve (mythologie)
Fȳræg	Bombe (militaire)
Ashley Tisdale	Ashley Tisdale
Þrondham	Trøndelag
Nīwe Woruld	Nouveau Monde
Fȳrweorc	Feu d'artifice
Æsc	Frêne
Galwæg	Galway
Ēadweard Andettere	Édouard le Confesseur
Hramsa	Allium ursinum
Scīdfarung	Ski
World of Warcraft	World of Warcraft
Byrig þāra Geāndena Rīca	Liste des villes les plus peuplées des États-Unis
Nemniendlic cāsus	Nominatif
Folcawanderung	Invasions barbares
Slayer	Slayer
Maria Scotta Cwēn	Marie Stuart (reine d'Écosse)
Indisc rīce	États et territoires de l'Inde
Scield	Bouclier (arme)
Henry V Englalandes	Henri V (roi d'Angleterre)
Sciþþia	Scythes
Universidade Federal de Minas Gerais	Université fédérale du Minas Gerais
Pulgare	Bulgares
Lyftscip	Ballon dirigeable
Cnut se Micela	Knut le Grand
Saturnus	Saturne (mythologie)
Exanceaster	Exeter
Sanctes Laurentes Ēa	Fleuve Saint-Laurent
Mundlēow	Évier
Sūþhjaltland	Îles Shetland du Sud
Cartespil	Jeu de cartes
Iscimbag	Ichimbaï
Basu Heorte	Purple Heart
Crecganford	Crayford
Marianburg	Malbork
Tenczynek	Tenczynek
Rudno	Rudno (Petite-Pologne)
Rudawa	Rudawa (Petite-Pologne)
Rosseg	Mainland (Orcades)
Nīwsǣlandworulddǣl	Zealandia
Carl Fǣtta Francena Cyning	Charles III le Gros
Þēodisc Āþbēorscipe	Confédération germanique
Cantwarabyrig eorþbeofung 2011.	Séisme de 2011 en Nouvelle-Zélande
Eorðæppelstycce	Frite
Rīnland	Rhénanie
Eormengyld Tybingenes	Université Eberhard Karl de Tübingen
Blōdmearh	Boudin noir
Midsumor	Midsummer
Timborwyrhta	Charpentier
Anlaf V Norrena Cyning	Olav V
Ēadweard Westseaxna Eorl	Edward de Wessex
Hacun VII Norrena Cyning	Haakon VII
Ecgbryht	Egbert de Wessex
Earnulf Carendran	Arnulf de Carinthie
Bēda	Bède le Vénérable
Laplandes Gūþ	Guerre de Laponie
Willelm-Alexander Niðerlanda Cyning	Willem-Alexander (roi des Pays-Bas)
Bredspearctellend	Tablette tactile
Mathusal	Mathusalem
Universidade Estadual de Feira de Santana	Université d'État de Feira de Santana
Bægware	Bavarii
Europisc wild gingifer	Asaret d'Europe
Bēowyrt	Acore odorant
Pontcysyllte Wætertyge	Pont-canal de Pontcysyllte
Universidade Federal da Bahia	Université fédérale de Bahia
Centro Federal de Educação Tecnológica de Minas Gerais	Centre fédéral d'éducation technologique du Minas Gerais
Nēohwæl	Narval
Ajman	Ajman (émirat)
Harold Godwinson	Harold Godwinson
Ȳþrīdung	Surf
Brū	Cil (anatomie)
Port:Stǣr	Drapeau du Tadjikistan
Kiæresburh	Cherbourg-Octeville
Bresl	Bretzel
CONCACAF	Confédération de football d'Amérique du Nord, d'Amérique centrale et des Caraïbes
Mentha arvensis	Menthe des champs
Searoburg	Salisbury (Angleterre)
Lunden Ēage	London Eye
Valdivia	Valdivia
Pachuca de Soto	Pachuca
Crāwlēac	Ail des vignes
Balsminte	Menthe aquatique
Dweorgedosle	Menthe pouliot
Landbūnes	Liste des dépendances et territoires à souveraineté spéciale
Rēadingas	Reading (Berkshire)
Mængo	Mangifera
Grēate Bryten Cynerīce	Royaume de Grande-Bretagne
Brōcminte	Menthe sylvestre
Iane Grey Hlæfdige	Jeanne Grey
Charmed	Charmed
Grammatisc cyn	Genre grammatical
Nica Ūphebbung	Sédition Nika
Sihþ	Vue
Brycgāðexe	Sphenodon
Hetware	Chattes
Americanisc wera rīcisc fōtballtēam	Équipe des États-Unis de soccer
Maywood, Illinois	Maywood (Illinois)
Þrēo Coreaniscu Cynerīcu	Trois Royaumes de Corée
Feðer (blæces)	Stylo
Pening	Pfennig
Bryttisca Antarctisca Landscipe	Territoire antarctique britannique
Starcraft	StarCraft
Seofon dēadlica synna	Péché capital
Zavodovski-īeg	Île Zavodovski
Finger	Majeur (anatomie)
Midwearme geardas	Climat tempéré
Angleseg	Anglesey
Niðerseaxisc sprǣc	Bas saxon
Māse	Paridae
Caselle Landi	Caselle Landi
Penwiðsteort	Land's End
Ratchet & Clank	Ratchet and Clank
Æðelstān Engla Cyning	Æthelstan
Ras al-Khaimah	Ras el Khaïmah (émirat)
Elene Constantinoples	Hélène (mère de Constantin)
Nintendo DS	Nintendo DS
Ēse	Ases
Nīwe Francland	Nouvelle-France
Englalandes Fana	Drapeau de l'Angleterre
Cyclades	Cyclades
Trafalgar Sǣfeoht	Bataille de Trafalgar
Iosephine Francena Caserin	Joséphine de Beauharnais
Sōlate	Tournesol
Cynelica Sciphere	Royal Navy
Inbærnes	Encens (résine oliban)
Difelinscīr	Comté de Dublin
Æppelcyrnel (wǣpen)	Grenade à main
Helm	Casque
Umm Al Quwain	Oumm al Qaïwaïn (émirat)
Nīwes Sǣlandes þēodlīc fōtþōðerhēap	Équipe de Nouvelle-Zélande de football
Ingang:Stǣr	Portail:Histoire
Nonne Etone	Nuneaton
The Oval	The Oval (Belfast)
2010 FIFA Woruldceampscipe	Coupe du monde de football de 2010
Sunu	Fils (parenté)
Caltojar	Caltojar
Grīpfealcen	Faucon gerfaut
Snāwbordfarung	Snowboard
Ōsgeard	Ásgard
Glīdflēogung	Parapente
Mageoscīr	Comté de Mayo
Australisc rīce	États et territoires de l'Australie
Blizzard Entertainment	Blizzard Entertainment
Gerinnung	Coagulation sanguine
Dofras	Douvres
Cannae Beadu	Bataille de Cannes
Herenuma	Prisonnier de guerre
Dȳfung	Plongée sous-marine
Daguerreotype	Daguerréotype
Dūnholm	Durham (Angleterre)
Þrēotīene Landbūnessa	Treize colonies
Brenda Song	Brenda Song
Lincoln	Lincoln (Royaume-Uni)
Syllīega	Îles Scilly
Smallville (TV endebyrdnes)	Smallville
Helen Clark	Helen Clark
Būr	Salle
Wēala Þēoden	Prince de Galles
Scōnīeg	Scanie
Milanes Bann	Édit de Milan
Francforta	Hot-dog
Gelocen boge	Arbalète (arme)
Meremægden	Sirène
Wichlawscīr	Comté de Wicklow
Striuelin	Stirling (ville)
Æðelred Unrǣd	Æthelred le Malavisé
Twentig Þūsend Lēowena Under þǣm Sǣ	Vingt mille lieues sous les mers
Baius	Bayeux
Ballōn (lyftcræft)	Ballon (aéronef)
Colneceaster	Colchester
Meodu	Hydromel
Met (Grammaticcræft)	Mode (grammaire)
Sǣelpend	Éléphant de mer
Grytviken	Grytviken
Fox News	Fox News Channel
Brīw	Bouillie
Ēadweard se Ieldra	Édouard l'Ancien
Iþacige	Ithaque
Baius tæpped	Tapisserie de Bayeux
Montréal Canadiens	Canadiens de Montréal
Underburg	Banlieue
Sharjah	Charjah (émirat)
Antrimscīr	Comté d'Antrim (Irlande)
Vigdís Finnbogadóttir	Vigdís Finnbogadóttir
Final Fantasy	Final Fantasy
Norrena Cyning	Liste des monarques de Norvège
Westmynster	Westminster
Ēadmund Æðeling	Edmond Ier
Rachel McAdams	Rachel McAdams
Fermanagh	Comté de Fermanagh
Dūnscīr	Comté de Down
E Pluribus Unum	E pluribus unum
Foresittend Franclandes	Président de la République française
New Jersey Devils	Devils du New Jersey
Philadelphia Flyers	Flyers de Philadelphie
Yun Chi-ho	Yun Chi-ho
Sancte Elene Īeg, Upstigeīeg and Tristan da Cunha	Sainte-Hélène, Ascension et Tristan da Cunha
Tirowen	Comté de Tyrone
Jack Ruby	Jack Ruby
Ardmachusscīr	Comté d'Armagh
Scene	Shannon (fleuve)
Wīnland	Vinland
Venom (trūðhlōð)	Venom (groupe)
Luel	Carlisle (Cumbria)
Ēadgar Engla Cyning	Edgar le Pacifique
Kea	Nestor kéa
Itumbiara	Itumbiara
A Night at the Opera	A Night at the Opera (album de Queen)
Queen (album)	Queen (album)
Þunres Hamor	Mjöllnir
Oben am jungen Rhein	Oben am jungen Rhein
Guinness	Guinness
Scræfclūdas (Sūþgeorgia)	Shag Rocks
Łobez	Łobez
Liðere	Fronde (arme)
Thomas Cranmer	Thomas Cranmer
Tawpomere	Lac Taupo
Universidad de Concepción	Université de Concepción
Hameldūn (Nīwe Sǣland)	Hamilton (Nouvelle-Zélande)
Stǣr þǣre Worulde	Histoire du monde
Rēad wulf	Loup rouge
Normandisca Forcyme	Conquête normande de l'Angleterre
Vitacura	Vitacura
Fif Scīr	Fife (Écosse)
Stǣrwrītere	Historien
Carolina Hurricanes	Hurricanes de la Caroline
Nebrond	Nimrod
Tampa Bay Lightning	Lightning de Tampa Bay
Scrobbesburh	Shrewsbury
Fæger hǣr	Blondeur
Napier (Nīwe Sǣland)	Napier (Nouvelle-Zélande)
Myrra	Myrrhe
Harold III Norrena Cyning	Harald III de Norvège
Fisc and styccu	Fish and chips
Brooke Fraser	Brooke Fraser
Middeltūn þǣra de Cahaignes	Milton Keynes
Florida Panthers	Panthers de la Floride
Washington Capitals	Capitals de Washington
Īrisc fōtþōðer	Football gaélique
Nīwes Sǣlandes Þēodlic Stēormǣlhēap	Parti national de Nouvelle-Zélande
West Loðene	West Lothian
Lonceaster	Lancaster (Angleterre)
Sūþalpis	Alpes du Sud (Nouvelle-Zélande)
Midloðene	Midlothian
Neamere	Lough Neagh
Wyrt	Herbe
Maðante	Mantes-la-Jolie
Ēast Loðene	East Lothian
Fermat tæl	Nombre de Fermat
Clackmannanscīr	Clackmannanshire
Liccidfeld	Lichfield
Sūþorcanege	Îles Orcades du Sud
Rænkīnes hātȝemet	Échelle Rankine
Se Fēolagascipe þæs Hringes	La Communauté de l'anneau
Cod	Gadidae
Gold (bleoh)	Or (couleur)
Holstānburg	Sisimiut
Micel Ficgīeg	Viti Levu
Wrenna	Troglodytidae
Ciricewæl	Kirkwall
1984 (bōc)	1984 (roman)
Folcaþing	Folketing
Underset gamen	Extension de jeu vidéo
Elig	Ely
Getalu burga in Þēodsclande	Liste des villes d'Allemagne
Innuendo	Innuendo (album)
Concepcion Hēafodcirice	Cathédrale de la Très Sainte Conception (Chili)
The Game	The Game (album de Queen)
Bancorena burg	Bangor
Gēol	Yule
Washington Redskins	Redskins de Washington
Swīma	Vertige
Ægelesburg	Aylesbury
Tristania	Tristania (groupe)
Wuldor	Ull
Ēsatrēowþ	Ásatrú
Lāmwic	Lerwick
Westgeatland	Västergötland
Rosenrot	Rosenrot
Wīcinga Ieldu	Âge des Vikings
Victory (scip)	HMS Victory (1765)
Sihhem	Naplouse
Beatrix Potter	Beatrix Potter
Ēadgar Æðeling	Edgar Atheling
Grēat Rōmisc Fȳr	Grand incendie de Rome
Tollund wer	Homme de Tollund
Hēapplega	Sport collectif
Levanger	Levanger
Violetta Villas	Violetta Villas
Ynce	Pouce (unité)
Gearwung (plega)	Activité physique
Diablo (gamen)	Diablo (jeu vidéo)
Anggun	Anggun
Verizon Center	Verizon Center
Wīfa rihta forðung	Droits des femmes
Apaxco	Apaxco
Cham	Cham (fils de Noé)
Zune	Zune
Nettþōðer	Netball
Lox	Lynx (homonymie)
In	IN
Diablo	Diablo
Wiltūn	Wilton
Roanoke	Roanoke
Cnut	Knut
Acan tūn	Acton
Eormengyld Ciles	Université du Chili
Sēremōnaþ 2007	Juin 2007
Offa Miercna Cyning	Offa de Mercie
Mǣdmōnaþ 2006	Juillet 2006
Mǣdmōnaþ 2007.	Juillet 2007
Wēodmōnaþ 2007	Août 2007
Engel	Ange
Sasha Cohen	Sasha Cohen
Rachael Taylor	Rachael Taylor
Æðelflǣd	Æthelflæd
Pat Benatar	Pat Benatar
Michelle Kwan	Michelle Kwan
Wæstm	Culture (agriculture)
Beate Eriksen	Beate Eriksen
Berhte Cent Cwēn	Berthe de Kent
D.C. United	D.C. United
Eowland	Öland
Starcraft II	StarCraft 2
Allan Kardec	Allan Kardec
Deadache	Deadache
Diablo III	Diablo III
Sceadu (gyden)	Skadi
Diablo II	Diablo II
Atlanta Thrashers	Thrashers d'Atlanta
Hwītlēachring	Beignet d'oignon
The God Delusion	Pour en finir avec Dieu
Canadisc fōtþōðer	Football canadien
Hæstingas (missenlīc gewritu)	Hastings
Ealra Hālgena Ǣfen	Halloween
Ēostre	Éostre
Sūþtun	Sutton
Weorcdæg	Temps de travail
Leðerhosu	Lederhose (vêtement)
Bān	Os
7 World Trade Center	7 World Trade Center
Vampire Knight	Vampire Knight
Wēodmōnaþ 2006	Août 2006
Ælfrīc Abbod of Egoneshame	Ælfric d'Eynsham
Ælle Sūþseaxna cyning	Ælle de Sussex
Æðelbald West-Seaxna Cyning	Æthelbald de Wessex
Æðelrǣd	Æthelred Ier de Mercie
Æðelstān	Æthelstan (homonymie)
Æðelstān Sūþseaxa Cyning	Æthelstan de Sussex
Ælfweard West-Seaxes	Ælfweard de Wessex
Bēagel	Bagel
Rēcels	Encens (fumigation)
Ūtwyrp	Télédiffusion
Iapanisc āttorcopplic crabba	Macrocheira kaempferi
Stromnæss, Sūþgeorgia	Stromness (Géorgie du Sud)
Woruldlic Gemōt þāra Ciricena	Conseil œcuménique des Églises
Blæcesburg, Virginia	Blacksburg (Virginie)
Harriet Miers	Harriet Miers
Dūnhēafod	Launceston (Cornouailles)
Ériu	Ériu
Marjorie Estiano	Marjorie Estiano
Ítróttarfelag Fuglafjarðar	ÍF Fuglafjørður
Fotþōðer	Football (homonymie)
Transformers	Transformers (homonymie)
Oresundes brycg	Øresundsbron
Ieshaiah	Isaïe (homonymie)
Denegield	Danegeld
Dohtor	Fille (parenté)
Spell Twēgra Burga	Le Conte de deux cités
Morbid Angel	Morbid Angel
John Ashcroft	John Ashcroft
Alexander Ovechkin	Aleksandr Ovetchkine
Orosius	Paul Orose
Alexis Tsipras	Aléxis Tsípras
Dufenal I Scotta	Donald Ier d'Écosse
Constontinus I Scotta Cyning	Constantin Ier d'Écosse
Joseph Serchuk	Joseph Serchuk
Seolfor (bleoh)	Gris argent
Babez for breakfast	Babez for Breakfast
Philip Jaisohn	Philip Jaisohn
Widukind	Widukind de Saxe
Wælheall Herig	Walhalla (bâtiment)
Æbbandūn	Abingdon-on-Thames
Law & Order	New York, police judiciaire
Westmannland	Västmanland
Moretoin	Mortain
Leaves' Eyes	Leaves' Eyes
Jeanette Biedermann	Jeanette Biedermann
Corn Flakes	Flocon de maïs
Amol	Amol
Penda Miercna Cyning	Penda
Dūnstān	Dunstan de Cantorbéry
Mælcolm II Scotta Cyning	Malcolm II d'Écosse
Ēadgar Scotta Cyning	Edgar d'Écosse
Ofergewiht	Surpoids
Constontinus II Scotta Cyning	Constantin II d'Écosse
Pak Hon-yong	Pak Hon-yong
Americanisc frēona rīcisc fōtballtēam	Équipe des États-Unis de soccer féminin
Obituary	Obituary
Mǣdmōnaþ 2005	Juillet 2005
Winterfylleþ 2005	Octobre 2005
Berserca	Berserk
Jordan Galland	Jordan Galland
Acrassicauda	Acrassicauda
Bēam	Beam
Minoru Yamasaki	Minoru Yamasaki
Offa	Offa
Tom	Tame (rivière)
Īslendisc stæfrǣw	Alphabet islandais
Canceler	Chancelier
Almaluez	Almaluez
Pulgara Cyning	Liste des souverains de Bulgarie
Cuneglæsse	Cynoglossum officinale
Ēadmund se Martyr	Edmond d'Est-Anglie
Australisca Witenagemōt	Parlement d'Australie
Lao	Lao (peuple)
Wīfel	Curculionoidea
Agalloch	Agalloch
Godspell Mattheus	Évangile selon Matthieu
Ēadweard Cyning Næss	King Edward Point
Uzumaki/ᚢᛋᚢᛗᚪᛦᛁ	Uzumaki
Ēadmund	Edmund
Palestinisce Landscipas	Territoires palestiniens occupés
Ajattara	Ajattara (groupe)
James Ēa	James River (Virginie)
Ȝ	Ȝ
Gærsīeg, Sūþgeorgia	Île Grass
Nazarēth	Nazareth
Rise of Nations	Rise of Nations
Kate Sheppard	Kate Sheppard
Geþingedōm	Subdivisions de l'Écosse
Getalu Smallville-belimpdǣla	Liste des épisodes de Smallville
Kwara Rīce	État de Kwara
Windlesōra	Windsor (Angleterre)
Ēastermōnaþ 2005	Avril 2005
America's Cup	Coupe de l'America
Wīnlendisc cystel	Châtaignier d'Amérique
Rædwald Ēastengla Cyning	Rædwald
Ēadbald	Eadbald de Kent
Oswiu Norþhymbra Cyning	Oswiu de Northumbrie
Brian Jacques	Brian Jacques
Agmodesham	Amersham
Paramore	Paramore
Recedham	Rochdale
Illative cāsus	Illatif
Herelic munucregol	Ordre militaire
Ǣȝhnōg	Lait de poule
Coritiba Foot Ball Club	Coritiba Foot Ball Club
Tansonnhates Geondrīciscum Lyfthæfene	Aéroport international de Tân Sơn Nhất
Þresc stīele	Thrash metal
The Chronicles of Narnia	Le Monde de Narnia
Aliud	Aliud
Iacub Colas	Yakub Kolas
Baraona	Baraona
James Hetfield	James Hetfield
Keane	Keane (groupe)
Medinaceli	Medinaceli
Láchar	Láchar
Burgo de Osma-Ciudad de Osma	El Burgo de Osma
Get Heavy	Get Heavy
Pensacola	Pensacola
The Arockalypse	The Arockalypse
Anath	Anat
San Esteban de Gormaz	San Esteban de Gormaz
The Monsterican Dream	The Monsterican Dream
Barbourscīr, Westvirginia	Comté de Barbour (Virginie-Occidentale)
Duval Scīr, Florida	Comté de Duval (Floride)
Hāmtūnscīr Scīr, West Virginia	Comté de Hampshire (Virginie-Occidentale)
Rēadgrot mid flīetan	Gruau de fruit
Samsung Galaxy Note	Samsung Galaxy Note
Perfume	Perfume (groupe)
Park Jung-yang	Park Jung-yang
Beadu Cealdre Hȳðe	Bataille de Cold Harbor
Rōwrenoc (Virginia)	Roanoke (Virginie)
Sūþtūn Hōh	Sutton Hoo
Tuidi	Tweed (fleuve)
Sǣbeorg	Mont sous-marin
Dornwaraceaster	Dorchester (Dorset)
Chris Pratt	Chris Pratt
Walhshalh	Walsall
Bēdesford, Virginia	Bedford (Virginie)
Ēadƿeard Æðeling Scīr, Virginia	Comté du Prince-Édouard (Virginie)
Angul	Angeln
Fiðele	Fiddle
Cambihtuc	Calopsitte élégante
Navaleno	Navaleno
Masters of the Universe	Les Maîtres de l'univers
Hwælsang	Chant des baleines
Boston Breakers	Breakers de Boston
Lanercscīr	Lanarkshire
Apulder	Appledore
Wyr, Orcanege	Wyre (Écosse)
Þrīnessunnandæg	Fête de la Sainte Trinité
Brecenscīr	Brecknockshire
Anna Ēastengla Cyning	Anna d'Est-Anglie
Simeon Varlamov	Semion Varlamov
Cannae	Cannes (Italie)
Debauchery	Debauchery
Þunresbeorg mōr	Thorsberg moor
Niht (gyden)	Nótt
Tamer	Tamar (fleuve)
Scīrburna	Sherborne
JavaScript weorcsearu	Moteur JavaScript
Mexicanisc frēona rīcisc fōtballtēam	Équipe du Mexique de football féminin
Læland	Lolland
Bukan	Bukan
God Hates Us All	God Hates Us All
Gemǣne Rīca of Australie	Gouverneur général d'Australie
FC Gold Pride	Football Club Gold Pride
Geþacasteort	Péninsule de Thatcher
Ælmer	Eilmer de Malmesbury
Grahamland	Terre de Graham
Wikipǣdia:Sceortpæþ	Aide:Raccourci
Mirai Nagasu	Mirai Nagasu
Eormengyld Juraj Dobrila on Pula	Université Juraj Dobrila de Pula
Dopenid	Fulica
Swearttægelhara	Lièvre de Californie
Sybelhūs on Lundne	Maison des banquets
Beadu þæs Bogn	Bataille de la Boyne
Puebla FC	CF Puebla
MorphOS	MorphOS
Atari Jaguar	Jaguar (console de jeux vidéo)
Smallville (Gēar 4)	Saison 4 de Smallville
Hēffe Wehbig	Haifa Wehbe
Augusta, West Virginia	Augusta (Virginie-Occidentale)
Ulfretūn	Newbury (Berkshire)
Tæppa	Robinet (plomberie)
Smallville (Gēar 3)	Saison 3 de Smallville
Nile (trūðhlōð)	Nile (groupe)
Ilfing	Elbląg (rivière)
Scēaþ	Fourreau
Stǣr Angelþēode ciricean	Histoire ecclésiastique du peuple anglais
Rēan	Rán
Vindicationīeg	Île Vindication
Tæfingstoc	Tavistock
Negombo	Negombo
Þrimilcemōnaþ 2005	Mai 2005
Blecinga īeg	Blekinge
Lox (catte)	Lynx
Gewuldorbeagungīeg (on Sūþorcanege)	Île du Couronnement
Æfterra Gēola 2005.	Janvier 2005
Huntandūn	Huntingdon (Angleterre)
Wyrd	Wyrd
Tomtun	Tamworth
City of Heroes	City of Heroes
World of Warcraft: Wrath of the Lich King	World of Warcraft: Wrath of the Lich King
Ambihtlicu Cīnisc sprǣc	Mandarin standard
Leþ Hæfen	Leith Harbour
Mans	Maine (province)
Hwicce	Hwicce
Falster	Falster
Janus (Windows beta)	Windows 3.x
Ealdfriþ	Aldfrith de Northumbrie
Difelinburg	Château de Dublin
SOX leoht-fæt	Lampe à vapeur de sodium
Madrynhȳð	Puerto Madryn
Solmōnaþ 2005	Février 2005
Hāligmōnaþ 2005	Septembre 2005
Atlanta Beat	Beat d'Atlanta
Wuduhen	Râle wéka
Gawain and se Grēna Cniht	Sire Gauvain et le Chevalier vert
Centro Federal de Educação Tecnológica Celso Suckow da Fonseca	Centre fédéral d'éducation technologique Celso Suckow da Fonseca
Chrono Trigger	Chrono Trigger
Antônio Fagundes	Antônio Fagundes
Cippanhamm	Chippenham
Télépopmusik	Télépopmusik
Selfrīcsiendlica landbūnessa	Région autonome
Berewicscīr	Berwickshire
Axanmynster	Axminster
Ægelesþrep	Aylesford (Kent)
Bloomesdæg	Bloomsday
Banffscīr	Banffshire
Barca	Barqa (Libye)
Beordan īeg	Bardney
Bardanstapol	Barnstaple
Bellingshausenīeg	Île Bellingshausen
Rīdungfȳrramm	Torpille humaine
Wedrebi	Wetherby
Adreminte	Tanacetum parthenium
Stæfford	Stafford (Angleterre)
Almarza	Almarza
Aldealices	Aldealices
Aldealafuente	Aldealafuente
Alentisque	Alentisque
Adradas	Adradas
Alconaba	Alconaba
Abejar	Abejar
Almajano	Almajano
Arenillas	Arenillas
Aldealpozo	Aldealpozo
Alcubilla de las Peñas	Alcubilla de las Peñas
Aldealseñor	Aldealseñor
Alcubilla de Avellaneda	Alcubilla de Avellaneda
Covaleda	Covaleda
Casarejos	Casarejos
Calatañazor	Calatañazor
Almazul	Almazul
Besliwdifca	Bezlioudivka
Alpanseque	Alpanseque
Arcos de Jalón	Arcos de Jalón
Aldehuela de Periáñez	Aldehuela de Periáñez
Beratón	Beratón
Almenar de Soria	Almenar de Soria
Cigudosa	Cigudosa
Ausejo de la Sierra	Ausejo de la Sierra
Valtajeros	Valtajeros
Arévalo de la Sierra	Arévalo de la Sierra
Castillejo de Robledo	Castillejo de Robledo
Las Aldehuelas	Las Aldehuelas
Oncala	Oncala
Ergo Proxy	Ergo Proxy
Ciria	Ciria
Duruelo de la Sierra	Duruelo de la Sierra
Borjabad	Borjabad
Quintana Redonda	Quintana Redonda
Yelo	Yelo
Langa de Duero	Langa de Duero
Miño de San Esteban	Miño de San Esteban
Santa María de Huerta	Santa María de Huerta
Deza	Deza
Stromnæs	Stromness (Écosse)
Rōmānisc Cāsere	Empereur romain
Weogornaceasterscīrsēaw	Sauce Worcestershire
Getalu ambihtlicra sprǣca	Liste des langues officielles
Maybach Exelero	Maybach Exelero
Īslendisc frēona rīcisc fōtþōðerhēap	Équipe d'Islande de football féminin
Worulde Fanan	Flags of the World
Hafoc	Buse (oiseau)
Dēaðas in 2005. gēare	Décès en 2005
York University	Université York
Hrēþmōnaþ 2005	Mars 2005
Cirenceaster	Cirencester
Strēoneshalh	Whitby (Angleterre)
Skræling	Skræling
BloodRayne 2	BloodRayne 2 (jeu vidéo, 2004)
Gēolmōnaþ 2004	Décembre 2004
Brytenwealda	Bretwalda
Glamorgan	Glamorgan
Winterfylleþ 2004	Octobre 2004
Sǣearmlandes Rīcisc Edisc	Parc national de Fiordland
Port Authority of New York and New Jersey	Port Authority of New York and New Jersey
Getalu īega be landware	Liste des îles par population
Cwatbrycg	Bridgnorth
Street Fighter IV	Street Fighter IV
Help:Innoþ	Aide:Sommaire
Wīntrēow	Plante grimpante
Brycgstōwīeg	Île Bristol
Groove is in the Heart	Groove Is in the Heart
Witch Hunter Robin	Witch Hunter Robin
Twilight of the Thunder God	Twilight of the Thunder God
Pontifícia Universidade Católica de Minas Gerais	Université pontificale catholique du Minas Gerais
Smallville (Gēar 5)	Saison 5 de Smallville
Deorwente	Derwent (Derbyshire)
Universidad de los Andes (Cile)	Université des Andes (Chili)
Oenoīeg	Oeno
3 World Trade Center	Three World Trade Center
Landa getalu be lēodweardcynne	Liste de pays par forme de gouvernement
Granta	Cam
Los Angeles Sol	Sol de Los Angeles
Waneting	Wantage
Hāligmōnaþ 2006	Septembre 2006
Hrodulf se rēadnosoda hrāndēor	Rudolphe le renne au nez rouge
Murilo Rosa	Murilo Rosa
2009–10 NHL tīma	Saison 2009-2010 de la LNH
John Clare	John Clare
Elpendīeg	Île de l'Éléphant
Getæl īega	Liste des listes d'îles
Dærentamūða	Dartmouth (Angleterre)
Elenesburh	Helensburgh
Exanmūþa	Exmouth (Angleterre)
Sūþern Strēamflēot	Kangerlussuaq
Tottaness	Totnes
Mældūn	Maldon (Essex)
Vrahovice	Vrahovice
Walhshalh Weald	Walsall Wood
Hlydanford	Lydford
Gēatland	Gotland
Būc	Estomac
Candelmæssanīeg	Île Candlemas
Loppestre	Nephropidae
Blōtmōnaþ 2004	Novembre 2004
Rello	Rello
Nīwes Sǣlandes Weorces Stēormǣlhēap	Parti travailliste néo-zélandais
Unicron	Unicron
Stǣr Floridan	Histoire de la Floride
Simeon II Pulgara Cyning	Siméon II de Bulgarie
Lopphāma	Weta
Heortæppelbroþ	Soupe de tomate
Chicago Red Stars	Red Stars de Chicago
Cutey Honey	Cutey Honey
Besancurt	Bézancourt
Clarenceīeg, Sūþhjaltland	Île Clarence (Îles Shetland du Sud)
Umm Culþþūm	Oum Kalthoum
Tenercebrai	Tinchebray
2 World Trade Center	Two World Trade Center
Cōcīeg (þāra Sūþsandwic Īeglanda)	Île Cook (Îles Sandwich du Sud)
Cooperīeg	Île de Cooper (Géorgie du Sud)
Universidade Tecnológica Federal do Paraná	Université technologique fédérale du Paraná
Stæffordscīr hord	Trésor du Staffordshire
Gemyndigung Twintorra	Mémorial du 11-Septembre
Swamphæn	Talève
Froggmann	Nageur de combat
Roanoke Express	Express de Roanoke
Beadu Omdurmanes	Bataille d'Omdurman
Cridiantūn	Crediton
Ƿ	Ƿ
Ninus	Ninus
Lundene Foreweard (1839.)	Traité des XXIV articles
Hellraiser	Le Pacte (film, 1987)
Harrogætes hord	Trésor d'Harrogate
Æsir–Vanir þurhgefeht	Guerre entre les Ases et les Vanes
Elisabeþ Cwēn Land	Terre de la Reine-Élisabeth
Teach Children to Worship Satan	Teach Children to Worship Satan
Wikipǣdia:Ambihtsecghof	Wikipédia:Ambassade
Sēo Rād tō Wiganshwearfe	Le Quai de Wigan
Mǣþ	Fenaison
National Hockey League	Ligue nationale de hockey
Striuelinscīr	Stirlingshire
Frōm	Frome
Dorceceaster	Dorchester (Oxfordshire)
Seleciricescīr	Selkirkshire
Perþscīr	Perthshire
2010 WPS tīma	Saison 2010 de Women's Professional Soccer
Grēat Langtūn	Great Langton
Flyhthæfen	Aéroport
Drēag	Draugr
Universidad de Santiago de Chile	Université de Santiago
Mare	Cauchemar (folklore)
Sandeg, Orcanege	Sanday (Orcades)
Sundrodland	Cité de Sunderland
Beadu Fossalta	Bataille de Fossalta
Egilseg	Egilsay
Leskovīeg	Île Leskov
Love Machine (sang)	Love Machine (chanson de Morning Musume)
Major Antônio Couto Pereira Stadium	Stade Major-Antônio-Couto-Pereira
Nīwes Sǣlandes Grēne Stēormǣlhēap	Parti vert d'Aotearoa Nouvelle-Zélande
Pecland	Parc national de Peak District
Uzumaki	Spirale (manga)
4 World Trade Center	Four World Trade Center
KMFDM	KMFDM
Women's Professional Soccer	Women's Professional Soccer
Sǣweardþrēat	Garde-côtes
Agnes Monica	Agnes Monica
Montaguīeg	Île Montagu
Windlesōra and Mægdenhȳþ	Windsor and Maidenhead
Wīdsīð	Widsith
Evile	Evile
Pasquier Quesnel	Pasquier Quesnel
Eoh	Eihwaz
Feoh (rūnstæf)	Fehu
Flocc:Ƿeras	Catégorie:Homme
Flocc:Ƿīf	Catégorie:Personnalité féminine
Flocc:Þēodscland	Catégorie:Allemagne
Flocc:Italia	Catégorie:Italie
Flocc:Geānedu Rīcu American	Catégorie:États-Unis
Flocc:Russland	Catégorie:Russie
Flocc:Canada	Catégorie:Canada
Flocc:Geānede Cynerīce	Catégorie:Royaume-Uni
Flocc:Spēonland	Catégorie:Espagne
Flocc:Cīna	Catégorie:Chine
Flocc:Iapan	Catégorie:Japon
Flocc:Australia	Catégorie:Australie
Flocc:Mexico	Catégorie:Mexique
Flocc:Indea	Catégorie:Inde
Flocc:Saudisc Arabea	Catégorie:Arabie saoudite
Flocc:Israhēl	Catégorie:Israël
Flocc:Turcland	Catégorie:Turquie
Flocc:Sūðaffrica	Catégorie:Afrique du Sud
Flocc:Ǣgypt	Catégorie:Égypte
Flocc:Persealand	Catégorie:Iran
Flocc:Nīwe Sǣland	Catégorie:Nouvelle-Zélande
Flocc:Argentina	Catégorie:Argentine
Wergyld	Wergeld
Sky Blue FC	Sky Blue Football Club
Flocc:Afghanistan	Catégorie:Afghanistan
Flocc:Algeria	Catégorie:Algérie
Flocc:Ēastrīce	Catégorie:Autriche
Flocc:Bangladesc	Catégorie:Bangladesh
Flocc:Cūba	Catégorie:Cuba
Flocc:Sigelhearwenaland	Catégorie:Éthiopie
Flocc:Indonesia	Catégorie:Indonésie
Flocc:Irac	Catégorie:Irak
Flocc:Niðerland	Catégorie:Pays-Bas
Flocc:Nigeria	Catégorie:Nigeria
Flocc:Pacistan	Catégorie:Pakistan
Flocc:Pōlaland	Catégorie:Pologne
Flocc:Portugal	Catégorie:Portugal
Flocc:Sudan	Catégorie:Soudan
Flocc:Tansania	Catégorie:Tanzanie
Flocc:Ucrægna	Catégorie:Ukraine
Flocc:Fietnam	Catégorie:Viêt Nam
Flocc:Rōmānisc Cāsere	Catégorie:Empire romain
Flocc:Sycedēor	Catégorie:Mammifère
Flocc:Fugolas	Catégorie:Oiseau
Flocc:Plantan	Catégorie:Plante
Flocc:Stǣr	Catégorie:Histoire
Flocc:Ferscipe	Catégorie:Société
Flocc:Gelēafan	Catégorie:Religion
Flocc:Plegan	Catégorie:Sport
Flocc:Sprǣc	Catégorie:Langage
Flocc:Eorþ	Catégorie:Terre
Victor Iusccenco	Viktor Iouchtchenko
Slowly We Rot	Slowly We Rot
Surtur Rising	Surtur Rising
Thila-īeg	Île Thule
Gealdor	Galdr
Lēo Hlāford Wǣponcyning	Lord Lyon
Saint Louis Athletica	Athletica de Saint-Louis
Palmerland	Terre de Palmer
Pagetbeorg	Mont Paget
World Trade Center 5 Torr	5 World Trade Center
Hedingelei	Headingley
Frēodōm	Freedom
MTB	Vedette-torpilleur
Īsensmiþ	Forgeron
Visokoi-īeg	Île Visokoi
Willisīega	Îles Willis
Wiogoraceastre	Worcester
Abbodesse	Abbesse
Ganet	Morus (oiseau)
Geondrīciscra laga fōtþōðer	Football de règles internationales
Mōr	Tourbière
Ranko Matasović	Ranko Matasović
Pickersgillīega	Îles Pickersgill
Três Pontas	Três Pontas
Swǣfisc cnotta	Chignon suève
Truso	Truso
Saundersīeg	Île Saunders
Ānlāfes Æþelinges Hæfen	Prince Olav Harbour
Sydneycofa	Sydney Cove
The Miracles	The Miracles
Universidad del Desarrollo	Université du développement
Tasca1:	Notes tironiennes
Smith & Wesson 500	S&W Modèle 500
Hwæl	Baleine
Tempest 2000	Tempest 2000
Apulder on Cente	Appledore (Kent)
Ælmhām	North Elmham
Philadelphia Independence	Independence de Philadelphie
Flocc:Olympisc Gamen	Catégorie:Jeux olympiques
Flocc:Crīstendōm	Catégorie:Christianisme
Flocc:Alladōm	Catégorie:Islam
Godmundingahām	Goodmanham
Ieldra Fuþark	Vieux futhark
Beorgford	Burford
Decatur	Decatur
Wilcumanīega	Îles Welcome
Ammomanes	Ammomanes
Earn	Aigle
Scyrte	Jupe
Abercurnig	Abercorn (Écosse)
Wyomingdenu wæl	Bataille de la Wyoming Valley
Oferferung on Francenarīce	Transport en France
Benesingtūn	Benson (Oxfordshire)
Smallville	Smallville (comics)
Elpend	Elephantidae
Elworuldontygenes	Altermondialisme
Bochotnica	Bochotnica
Anna Hutchison	Anna Hutchison
Universidade do Estado de Minas Gerais	Universidade do Estado de Minas Gerais
Grantasæte	Grantchester
Adesa	Herminette
Abiron	Abiron
Mageo	Mayo Abbey
Brecenanmere	Lac de Llangorse
Mancus	Mancus
Āhyrstod cȳse	Grilled cheese
Harads	Harads
Nægling	Nægling
Sceota	Salmo trutta
Camila Morgado	Camila Morgado
Flocc:Styccelicu gewritu	Catégorie:Wikipédia:ébauche
Flocc:Sidaþing	Catégorie:Culture
Flocc:Gēar	Catégorie:Année
Flocc:Worulddǣl	Catégorie:Continent
Flocc:Lyftcræftas	Catégorie:Type d'aéronef
Ciricehūs	Church House
Getalu þāra Atari Jaguares gamena	Liste de jeux Jaguar
Gealdorstæf	Symboles magiques islandais
Nexus: The Jupiter Incident	Nexus: The Jupiter Incident
Nīwe Eoforwīcingas	Démographie de l'État de New York
The Tonight Show with Jay Leno	The Tonight Show with Jay Leno
Sprǣca merung	Miriwoong
Hæstingas (Englisc þēod)	Hæstingas
Wikipǣdia:Gecorene gemynddagas	Wikipédia:Éphéméride
Bysen:Stēorungsunnanendebyrdnes	Modèle:Palette Système solaire
Smiþþfeld, Lunden	Smithfield (Londres)
Wikipǣdia:Nīwe ēacan	Wikipédia:Le saviez-vous ?
Wikipǣdia:Wikibōceras	Wikipédia:Wikipédiens
Wikipǣdia:Snell bīcniend	Wikipédia:Index alphabétique
Wikipǣdia:Recentchanges	Aide:Modifications récentes
Basu	Pourpre
Ode to a Nightingale	Ode à un rossignol
Bysen:Succession box	Modèle:Succession/Ligne
Skyhammer	Skyhammer
Flocc:Flēogeball	Catégorie:Volley-ball
Flocc:Wikipedia bots	Catégorie:Bot Wikipédia
Port:Gefērscipe	Portail:Société
Ened	Canard
Bysen:Cquote	Modèle:Citation
Flocc:Þēodisc	Catégorie:Personnalité allemande
Caco Ciocler	Caco Ciocler
Eormengyld ''Guglielmo Marconi''	Université Guglielmo-Marconi
Flocc:Land	Catégorie:Pays
Catherine	Catherine
Wikipǣdia:Bewitendas	Wikipédia:Administrateur
Flocc:Lēode	Catégorie:Personnalité
Wikipǣdia:Bēna tō and fram bewitendhāde	Wikipédia:Candidature au statut d'administrateur
Flocc:Tīd	Catégorie:Temps
Flocc:Bodiȝlār	Catégorie:Anatomie
Wikipǣdia:Betwuxsprǽclice bendas	Aide:Lien interlangue
Flocc:Leornung	Catégorie:Éducation
Cyningesbeorg	Königsberg
Ægypt	Égypte
Yulia Lipnitskaya	Ioulia Lipnitskaïa
Flocc:Ūtwitan	Catégorie:Philosophe
Bysen:Bot	Modèle:Bot
Wikipǣdia:Hwæt Wikipǣdia Nis	Wikipédia:Ce que Wikipédia n'est pas
Canada	Canada
Flocc:Ungerland	Catégorie:Hongrie
Flocc:Belgice	Catégorie:Belgique
Flocc:Cipros	Catégorie:Chypre
Flocc:Cecland	Catégorie:République tchèque
Flocc:Denemearc	Catégorie:Danemark
Flocc:Estland	Catégorie:Estonie
Flocc:Finnland	Catégorie:Finlande
Flocc:Crecaland	Catégorie:Grèce
Flocc:Lettland	Catégorie:Lettonie
Flocc:Īsland	Catégorie:Islande
Flocc:Letseburg	Catégorie:Luxembourg
Flocc:Liþuania	Catégorie:Lituanie
Flocc:Melita	Catégorie:Malte
Flocc:Swēoland	Catégorie:Suède
Flocc:Slofacia	Catégorie:Slovaquie
Flocc:Īrland Cynewīse	Catégorie:Irlande
Flocc:Fulgōd ȝeƿritu	Catégorie:Article de qualité
Flocc:Spærcletelle gamen	Catégorie:Jeu vidéo
Heofon	Ciel (religion)
Fresland	Frise (région historique)
Flocc:Microsoft	Catégorie:Microsoft
Wikipǣdia:Edit summary	Aide:Boîte de résumé
Bysen:Flagicon	Modèle:Drapeau
Flocc:Land on Europan	Catégorie:Pays d'Europe
Flocc:Europe	Catégorie:Europe
Flocc:Wikipedia:Help	Catégorie:Espace Aide
Help:Mōtungtramet	Aide:Discussion
Wikipǣdia:Efenealde belimpas	Portail:Actualité
Bysen:Documentation	Modèle:Documentation
Wikipǣdia:Protected pages	Wikipédia:Protection
Flocc:Wikibōceras	Catégorie:Wikipédiens
Wikipǣdia:Gemǣnscipes Ingang	Wikipédia:Accueil de la communauté
Flocc:Brūcendsprǣc	Catégorie:Wikipédiens par langue
Wikipǣdia:Fīf styde	Wikipédia:Principes fondateurs
Wikipǣdia:Ānsund styccegewrit	Aide:Ébauche
Wikipǣdia:Bealu	Wikipédia:Vandalisme
Sung Jae-ki	Sung Jae-ki
Sundorrīcesdæg	Jour de l'indépendance
Instituto Federal da Bahia	École polytechnique fédérale de Bahia
Bysen:Softredirect	Modèle:Redirection douce
Bysen:Delete	Modèle:Suppression Immédiate
Snægel	Gastropoda
Bryttisce Wealdendas	Liste des monarques britanniques
Flocc:Searucræft	Catégorie:Technologie
Flocc:Sprǣca	Catégorie:Langue
Flocc:Gerīmbōc	Catégorie:Calendrier
Flocc:Hāliȝdagas	Catégorie:Jour férié
Help:Onbregdan nīwne tramet	Aide:Comment créer un article
Flocc:Wikipǣdia	Catégorie:Wikipédia
Flocc:Pages with broken file links	Catégorie:Page avec des liens de fichiers brisés
Wikipǣdia:Manual of Style	Wikipédia:Conventions de style
Bysen:Navbox	Modèle:Méta palette de navigation
Handspearctellend	Appareil mobile
Flocc:Byrig on Persum	Catégorie:Ville d'Iran
Roy Moore	Roy Moore
Bysen:Sēðung þurfed	Modèle:Citation nécessaire
Angelfresisca sprǣca	Anglo-frison
Bysen:!	Modèle:!
Flocc:Fana bysen	Catégorie:Modèle drapeau
Bysen:((	Modèle:((
Bysen:!-	Modèle:!-
Bysen:!!	Modèle:!!
Bysen:=	Modèle:=
Bysen:Navbar	Modèle:Tnavbar
Bysen:Unicode	Modèle:UCode
Bysen:E	Modèle:X10
Bysen:Clear	Modèle:Clr
Bysen:Col-break	Modèle:Col-break
Bysen:Col-begin	Modèle:Col-début
Bysen:Col-end	Modèle:Col-fin
Bysen:Color	Modèle:Coloré
Bysen:Anchor	Modèle:Ancre
Wikipǣdia:List of articles all languages should have	Wikipédia:Articles vitaux
Flocc:Affrica	Catégorie:Afrique
Flocc:Mǣdmōnaþ	Catégorie:Juillet
Flocc:Þorpas	Catégorie:Village
Flocc:Bēc	Catégorie:Livre
Flocc:Mōnþas	Catégorie:Mois
Bysen:Wikisource	Modèle:Wikisource
Bysen:Babel	Modèle:Boîte Babel
Bysen:Commons	Modèle:Commons
Bysen:Reflist	Modèle:Références
Bysen:NavPeriodicTable	Modèle:Infobox Élément/Mini table périodique
Bysen:Stycce	Modèle:Ébauche
Bysen:Brūcend de	Modèle:Utilisateur de
Bysen:Brūcend de-1	Modèle:Utilisateur de-1
Bysen:Brūcend el	Modèle:Utilisateur el
Bysen:Brūcend es	Modèle:Utilisateur es
Bysen:Brūcend de-3	Modèle:Utilisateur de-3
Bysen:Brūcend en-3	Modèle:Utilisateur en-3
Bysen:Brūcend el-1	Modèle:Utilisateur el-1
Bysen:Brūcend en-1	Modèle:Utilisateur en-1
Bysen:Brūcend en-2	Modèle:Utilisateur en-2
Bysen:Brūcend eo-2	Modèle:Utilisateur eo-2
Bysen:Brūcend en-4	Modèle:Utilisateur en-4
Bysen:Brūcend fi	Modèle:Utilisateur fi
Bysen:Brūcend en-0	Modèle:Utilisateur en-0
Bysen:Brūcend es-4	Modèle:Utilisateur es-4
Bysen:Brūcend en	Modèle:Utilisateur en
Bysen:Brūcend de-2	Modèle:Utilisateur de-2
Bysen:Brūcend es-1	Modèle:Utilisateur es-1
Bysen:Brūcend fi-1	Modèle:Utilisateur fi-1
Bysen:Brūcend fr-1	Modèle:Utilisateur fr-1
Flocc:Līf	Catégorie:Vivant
Bysen:Brūcend he-2	Modèle:Utilisateur he-2
Bysen:Brūcend it-3	Modèle:Utilisateur it-3
Bysen:User sk	Modèle:Utilisateur sk
Bysen:Brūcend fr-2	Modèle:Utilisateur fr-2
Bysen:Brūcend ja	Modèle:Utilisateur ja
Bysen:Brūcend ja-1	Modèle:Utilisateur ja-1
Bysen:Brūcend it-1	Modèle:Utilisateur it-1
Bysen:Brūcend fr	Modèle:Utilisateur fr
Cosco	Cuzco
Flocc:Solmōnaþ	Catégorie:Février
Flocc:1949	Catégorie:1949
Flocc:Ceorfdēor	Catégorie:Insecte
Bysen:Fs mid	Modèle:Fs mid
Flocc:Asia	Catégorie:Asie
Flocc:Cile	Catégorie:Chili
Flocc:21e gēarhundred	Catégorie:XXIe siècle
Flocc:Lesotho	Catégorie:Lesotho
Flocc:Brūcend uk	Catégorie:Utilisateur uk
Flocc:Sūðamerica	Catégorie:Amérique du Sud
Flocc:Brūcend uk-M	Catégorie:Utilisateur uk-M
Flocc:1918	Catégorie:1918
Flocc:1954	Catégorie:1954
Flocc:Ǣt	Catégorie:Aliment
Flocc:1946	Catégorie:1946
Bysen:Fs player	Modèle:Fs player
Flocc:Gyldfōtþōðer	Catégorie:Football
Flocc:1945	Catégorie:1945
Bysen:Mod	Modèle:Mod
Flocc:1926	Catégorie:1926
Bysen:NowCommons	Modèle:Image sur Commons
Bysen:Brūcend sv	Modèle:Utilisateur sv
Flocc:1920	Catégorie:1920
Bysen:Brūcend it	Modèle:Utilisateur it
Bysen:Brūcend uk	Modèle:Utilisateur uk
Bysen:Brūcend es-2	Modèle:Utilisateur es-2
Bysen:Welcome	Modèle:Bienvenue nouveau
Flocc:Bysen mid ūtweardum hlence	Catégorie:Modèle créant un lien externe
Bysen:Mōnþas	Modèle:Palette Mois
Bysen:Country data Slovakia	Modèle:Country data Slovaquie
Bysen:Country flagnavy	Modèle:Marine de guerre/callback
Bysen:Country data Czech Republic	Modèle:Country data République tchèque
Bysen:Country data Honduras	Modèle:Country data Honduras
Bysen:Country data Bolivia	Modèle:Country data Bolivie
Bysen:Country data Denemearc	Modèle:Country data Danemark
Bysen:Country data Īsland	Modèle:Country data Islande
Bysen:Country data Poland	Modèle:Country data Pologne
Bysen:Scire in Irlande	Modèle:Palette Comté d'Irlande
Bysen:Wikivar	Modèle:Wikivar
Flocc:Brūcend fr-1	Catégorie:Utilisateur fr-1
Bysen:Country data Norway	Modèle:Country data Norvège
Bysen:Wikiquote	Modèle:Wikiquote
Bysen:Country showdata	Modèle:Country showdata
Bysen:Country data Mexico	Modèle:Country data Mexique
Bysen:Affrica	Modèle:Palette Pays d'Afrique
Bysen:Infobox television	Modèle:Infobox Émission de télévision
Flocc:Americisc Awendung Wig	Catégorie:Révolution américaine
Bysen:FWB	Modèle:FWB
Bysen:Geānedu Rīcu American	Modèle:Palette États des États-Unis
Bysen:Country data Australia	Modèle:Country data Australie
Bysen:Cyþþubox ieg	Modèle:Infobox Île
Bysen:Country data France	Modèle:Country data France
Bysen:Ambox	Modèle:Méta bandeau d'avertissement
Flocc:Americanisc stǣr	Catégorie:Histoire des États-Unis
Bysen:Infobox Country	Modèle:Infobox Pays
Bysen:Max	Modèle:Max
Bysen:Country data Austria	Modèle:Country data Autriche
Bysen:Infobox Mīlitisc Gemōt	Modèle:Infobox Conflit militaire
Bysen:Documentation/docname	Modèle:Documentation/docname
Bysen:Country data Finland	Modèle:Country data Finlande
Wikipǣdia:Tutorial (Wikipedia links)	Wikipédia:Liens internes
Bysen:Country data Japan	Modèle:Country data Japon
Bysen:Start box	Modèle:S-start
Bysen:Infobox U.S. Scīr	Modèle:Infobox Comté des États-Unis
Bysen:Cleanup	Modèle:À recycler
Flocc:Crabbas	Catégorie:Brachyura
Bysen:Cite journal	Modèle:Article
Bysen:Lang-ar	Modèle:En arabe
Bysen:Brūcend es-0	Modèle:Utilisateur es-0
Bysen:Cite news	Modèle:Cite news
Bysen:Featured article	Modèle:Article de qualité
Bysen:Country data Russia	Modèle:Country data Russie
Flocc:Paris	Catégorie:Paris
Flocc:Brūcend en-4	Catégorie:Utilisateur en-4
Flocc:Brūcend en	Catégorie:Utilisateur en
Flocc:Croatia	Catégorie:Croatie
Flocc:Brūcend en-2	Catégorie:Utilisateur en-2
Flocc:Francena cyningas	Catégorie:Roi de France
Flocc:Stafas	Catégorie:Alphabet
Bysen:Template other	Modèle:Template other
Wikipǣdia:Gecorene gemynddagas/4 Solmōnaþ	Wikipédia:Éphéméride/4 février
Bysen:Lang-da	Modèle:Lang-da
Wikipǣdia:Gecorene gemynddagas/18 Solmōnaþ	Wikipédia:Éphéméride/18 février
Wikipǣdia:Gecorene gemynddagas/28 Æfterra Gēola	Wikipédia:Éphéméride/28 janvier
Bysen:Legend	Modèle:Légende
Wikipǣdia:Gecorene gemynddagas/14 Æfterra Gēola	Wikipédia:Éphéméride/14 janvier
Wikipǣdia:Gecorene gemynddagas/25 Solmōnaþ	Wikipédia:Éphéméride/25 février
Flocc:Bryttisce wrīteras	Catégorie:Écrivain britannique
Bysen:Cite web	Modèle:Lien web
Wikipǣdia:Gecorene gemynddagas/21 Æfterra Gēola	Wikipédia:Éphéméride/21 janvier
Wikipǣdia:Gecorene gemynddagas/8 Solmōnaþ	Wikipédia:Éphéméride/8 février
Bysen:Country data Italy	Modèle:Country data Italie
Wikipǣdia:Gecorene gemynddagas/20 Æfterra Gēola	Wikipédia:Éphéméride/20 janvier
Wikipǣdia:Gecorene gemynddagas/23 Æfterra Gēola	Wikipédia:Éphéméride/23 janvier
Bysen:Imdb title	Modèle:Imdb titre
Wikipǣdia:Gecorene gemynddagas/31 Gēolmōnaþ	Wikipédia:Éphéméride/31 décembre
Wikipǣdia:Gecorene gemynddagas/1 Solmōnaþ	Wikipédia:Éphéméride/1 février
Wikipǣdia:Gecorene gemynddagas/14 Gēolmōnaþ	Wikipédia:Éphéméride/14 décembre
Wikipǣdia:Gecorene gemynddagas/25 Æfterra Gēola	Wikipédia:Éphéméride/25 janvier
Wikipǣdia:Gecorene gemynddagas/18 Æfterra Gēola	Wikipédia:Éphéméride/18 janvier
Bysen:Country data	Modèle:Country data
Wikipǣdia:Gecorene gemynddagas/5 Winterfylleþ	Wikipédia:Éphéméride/5 octobre
Wikipǣdia:Gecorene gemynddagas/15 Solmōnaþ	Wikipédia:Éphéméride/15 février
Bysen:Coor URL	Modèle:Coord/URL
Bysen:Notice	Modèle:Notice
Bysen:Pp-template	Modèle:Protection
Bysen:·	Modèle:·
Bysen:Brūcend nl-1	Modèle:Utilisateur nl-1
Bysen:Infobox Winodland	Modèle:Infobox Ville de Pologne
Bysen:Min	Modèle:Min
Bysen:Wiktionarypar2	Modèle:Wiktionnaire
Bysen:Brūcend nl-2	Modèle:Utilisateur nl-2
Bysen:Infobox Ice Hockey Player	Modèle:Infobox Personnalité du hockey sur glace
Bysen:Country data Sweden	Modèle:Country data Suède
Flocc:Byrig on Dēnum	Catégorie:Ville du Danemark
Flocc:Eorþtilþ	Catégorie:Agriculture
Wikipǣdia:Gecorene gemynddagas/12 Gēolmōnaþ	Wikipédia:Éphéméride/12 décembre
Wikipǣdia:Gecorene gemynddagas/10 Æfterra Gēola	Wikipédia:Éphéméride/10 janvier
Wikipǣdia:Gecorene gemynddagas/31 Æfterra Gēola	Wikipédia:Éphéméride/31 janvier
Wikipǣdia:Gecorene gemynddagas/6 Hrēþmōnaþ	Wikipédia:Éphéméride/6 mars
Wikipǣdia:Gecorene gemynddagas/18 Hrēþmōnaþ	Wikipédia:Éphéméride/18 mars
Wikipǣdia:Gecorene gemynddagas/19 Hrēþmōnaþ	Wikipédia:Éphéméride/19 mars
Wikipǣdia:Gecorene gemynddagas/10 Hrēþmōnaþ	Wikipédia:Éphéméride/10 mars
Wikipǣdia:Gecorene gemynddagas/26 Solmōnaþ	Wikipédia:Éphéméride/26 février
Wikipǣdia:Gecorene gemynddagas/12 Solmōnaþ	Wikipédia:Éphéméride/12 février
Wikipǣdia:Gecorene gemynddagas/15 Æfterra Gēola	Wikipédia:Éphéméride/15 janvier
Wikipǣdia:Gecorene gemynddagas/16 Æfterra Gēola	Wikipédia:Éphéméride/16 janvier
Wikipǣdia:Gecorene gemynddagas/2 Æfterra Gēola	Wikipédia:Éphéméride/2 janvier
Wikipǣdia:Gecorene gemynddagas/9 Mǣdmōnaþ	Wikipédia:Éphéméride/9 juillet
Wikipǣdia:Gecorene gemynddagas/10 Solmōnaþ	Wikipédia:Éphéméride/10 février
Wikipǣdia:Gecorene gemynddagas/5 Hrēþmōnaþ	Wikipédia:Éphéméride/5 mars
Wikipǣdia:Gecorene gemynddagas/6 Æfterra Gēola	Wikipédia:Éphéméride/6 janvier
Wikipǣdia:Gecorene gemynddagas/23 Mǣdmōnaþ	Wikipédia:Éphéméride/23 juillet
Wikipǣdia:Gecorene gemynddagas/20 Gēolmōnaþ	Wikipédia:Éphéméride/20 décembre
Wikipǣdia:Gecorene gemynddagas/29 Æfterra Gēola	Wikipédia:Éphéméride/29 janvier
Wikipǣdia:Gecorene gemynddagas/5 Gēolmōnaþ	Wikipédia:Éphéméride/5 décembre
Wikipǣdia:Gecorene gemynddagas/25 Hrēþmōnaþ	Wikipédia:Éphéméride/25 mars
Wikipǣdia:Gecorene gemynddagas/9 Hrēþmōnaþ	Wikipédia:Éphéméride/9 mars
Wikipǣdia:Gecorene gemynddagas/12 Hrēþmōnaþ	Wikipédia:Éphéméride/12 mars
Wikipǣdia:Gecorene gemynddagas/11 Hrēþmōnaþ	Wikipédia:Éphéméride/11 mars
Wikipǣdia:Gecorene gemynddagas/19 Gēolmōnaþ	Wikipédia:Éphéméride/19 décembre
Wikipǣdia:Gecorene gemynddagas/24 Solmōnaþ	Wikipédia:Éphéméride/24 février
Wikipǣdia:Gecorene gemynddagas/13 Solmōnaþ	Wikipédia:Éphéméride/13 février
Wikipǣdia:Gecorene gemynddagas/20 Solmōnaþ	Wikipédia:Éphéméride/20 février
Wikipǣdia:Gecorene gemynddagas/5 Æfterra Gēola	Wikipédia:Éphéméride/5 janvier
Wikipǣdia:Gecorene gemynddagas/15 Hrēþmōnaþ	Wikipédia:Éphéméride/15 mars
Wikipǣdia:Gecorene gemynddagas/23 Solmōnaþ	Wikipédia:Éphéméride/23 février
Wikipǣdia:Gecorene gemynddagas/13 Hrēþmōnaþ	Wikipédia:Éphéméride/13 mars
Wikipǣdia:Gecorene gemynddagas/15 Gēolmōnaþ	Wikipédia:Éphéméride/15 décembre
Wikipǣdia:Gecorene gemynddagas/4 Hrēþmōnaþ	Wikipédia:Éphéméride/4 mars
Wikipǣdia:Gecorene gemynddagas/4 Mǣdmōnaþ	Wikipédia:Éphéméride/4 juillet
Wikipǣdia:Gecorene gemynddagas/13 Æfterra Gēola	Wikipédia:Éphéméride/13 janvier
Wikipǣdia:Gecorene gemynddagas/27 Æfterra Gēola	Wikipédia:Éphéméride/27 janvier
Wikipǣdia:Gecorene gemynddagas/12 Æfterra Gēola	Wikipédia:Éphéméride/12 janvier
Wikipǣdia:Gecorene gemynddagas/30 Gēolmōnaþ	Wikipédia:Éphéméride/30 décembre
Wikipǣdia:Gecorene gemynddagas/3 Æfterra Gēola	Wikipédia:Éphéméride/3 janvier
Wikipǣdia:Gecorene gemynddagas/8 Æfterra Gēola	Wikipédia:Éphéméride/8 janvier
Wikipǣdia:Gecorene gemynddagas/14 Solmōnaþ	Wikipédia:Éphéméride/14 février
Wikipǣdia:Gecorene gemynddagas/19 Solmōnaþ	Wikipédia:Éphéméride/19 février
Wikipǣdia:Gecorene gemynddagas/20 Hrēþmōnaþ	Wikipédia:Éphéméride/20 mars
Wikipǣdia:Gecorene gemynddagas/6 Solmōnaþ	Wikipédia:Éphéméride/6 février
Wikipǣdia:Gecorene gemynddagas/7 Solmōnaþ	Wikipédia:Éphéméride/7 février
Wikipǣdia:Gecorene gemynddagas/21 Solmōnaþ	Wikipédia:Éphéméride/21 février
Wikipǣdia:Gecorene gemynddagas/14 Hrēþmōnaþ	Wikipédia:Éphéméride/14 mars
Wikipǣdia:Gecorene gemynddagas/8 Mǣdmōnaþ	Wikipédia:Éphéméride/8 juillet
Wikipǣdia:Gecorene gemynddagas/2 Solmōnaþ	Wikipédia:Éphéméride/2 février
Wikipǣdia:Gecorene gemynddagas/17 Æfterra Gēola	Wikipédia:Éphéméride/17 janvier
Wikipǣdia:Gecorene gemynddagas/3 Solmōnaþ	Wikipédia:Éphéméride/3 février
Bysen:Lang-sr	Modèle:Lang-sr
Wikipǣdia:Gecorene gemynddagas/16 Hrēþmōnaþ	Wikipédia:Éphéméride/16 mars
Wikipǣdia:Gecorene gemynddagas/17 Hrēþmōnaþ	Wikipédia:Éphéméride/17 mars
Wikipǣdia:Gecorene gemynddagas/5 Solmōnaþ	Wikipédia:Éphéméride/5 février
Flocc:Beorgas	Catégorie:Montagne
Bysen:Brūcend ru	Modèle:Utilisateur ru
Flocc:20e gēarhundred	Catégorie:XXe siècle
Bysen:IPA	Modèle:Prononciation API
Bysen:Bēc þǣre Nīwan Gecȳþnesse	Modèle:Palette Livres du Nouveau Testament
Bysen:USpresidents	Modèle:Palette Président des États-Unis
Wikipǣdia:Gecorene gemynddagas/7 Hrēþmōnaþ	Wikipédia:Éphéméride/7 mars
Flocc:Bysen Brūcend Box Spræc	Catégorie:Langue pour les boîtes utilisateurs
Wikipǣdia:Gecorene gemynddagas/28 Ēastermōnaþ	Wikipédia:Éphéméride/28 avril
Bysen:LangWithName	Modèle:Langue avec nom
Flocc:Hwæsingatūn	Catégorie:Washington (État)
Flocc:Wihta	Catégorie:Créature légendaire
Wikipǣdia:Gecorene gemynddagas/22 Solmōnaþ	Wikipédia:Éphéméride/22 février
Wikipǣdia:Gecorene gemynddagas/17 Solmōnaþ	Wikipédia:Éphéméride/17 février
Bysen:Birth date and age	Modèle:Date de naissance
Bysen:MONTHNAME	Modèle:MONTHNAME
Wikipǣdia:Gecorene gemynddagas/30 Æfterra Gēola	Wikipédia:Éphéméride/30 janvier
Wikipǣdia:Gecorene gemynddagas/9 Solmōnaþ	Wikipédia:Éphéméride/9 février
Wikipǣdia:Gecorene gemynddagas/8 Hrēþmōnaþ	Wikipédia:Éphéméride/8 mars
Bysen:Sortname	Modèle:TriNom
Flocc:Gebēd	Catégorie:Prière
Bysen:Country data Ireland	Modèle:Country data Irlande
Wikipǣdia:Gecorene gemynddagas/27 Solmōnaþ	Wikipédia:Éphéméride/27 février
Flocc:Country data templates	Catégorie:Modèle Country data
Wikipǣdia:Gecorene gemynddagas/Solmōnaþ	Wikipédia:Éphéméride/février
Bysen:Country data England	Modèle:Country data Angleterre
Flocc:19e gēarhundred	Catégorie:XIXe siècle
Bysen:Country data Republic of Ireland	Modèle:Country data République d'Irlande
Flocc:Wrīteras	Catégorie:Écrivain
Bysen:Country data Switzerland	Modèle:Country data Suisse
Flocc:Eormengyld	Catégorie:Université
Bysen:Lang-cs	Modèle:Lang-cs
Bysen:Lang-he	Modèle:Lang-he
Bysen:Infobox OS	Modèle:Infobox Système d'exploitation
Bysen:Brūcend pt-1	Modèle:Utilisateur pt-1
Flocc:Æfterra Gēola	Catégorie:Janvier
Bysen:Lang-fa	Modèle:Lang-fa
Bysen:End tab	Modèle:Fin des onglets
Bysen:Brūcend pl	Modèle:Utilisateur pl
Bysen:Brūcend nl	Modèle:Utilisateur nl
Bysen:Tab	Modèle:Onglet
Bysen:Brūcend pl-0	Modèle:Utilisateur pl-0
Bysen:Brūcend no-2	Modèle:Utilisateur no-2
Bysen:Start tab	Modèle:Début des onglets
Wikipǣdia:Gecorene gemynddagas/11 Solmōnaþ	Wikipédia:Éphéméride/11 février
Bysen:Australia	Modèle:Palette États et territoires de l'Australie
Wikipǣdia:Nospam	Wikipédia:Pages protégées à la création
Wikipǣdia:Gecorene gemynddagas/11 Æfterra Gēola	Wikipédia:Éphéméride/11 janvier
Bysen:Tlx	Modèle:Lien vers modèle avec paramètres
Bysen:CAN	Modèle:Canada
Bysen:Lang-de	Modèle:Lang-de
Bysen:Country data Austria-Hungary	Modèle:Country data Autriche-Hongrie
Bysen:Sæternes Bōtm	Modèle:Palette Satellites de Saturne
Bysen:Lang-la	Modèle:Lang-la
Flocc:Wucu	Catégorie:Semaine
Wikipǣdia:Gecorene gemynddagas/Gēolmōnaþ	Wikipédia:Éphéméride/décembre
Bysen:Infobox Album	Modèle:Infobox Musique (œuvre)
Bysen:User	Modèle:U
Wikipǣdia:Gecorene gemynddagas/16 Gēolmōnaþ	Wikipédia:Éphéméride/16 décembre
Wikipǣdia:Gecorene gemynddagas/9 Æfterra Gēola	Wikipédia:Éphéméride/9 janvier
Wikipǣdia:Gecorene gemynddagas/7 Æfterra Gēola	Wikipédia:Éphéméride/7 janvier
Wikipǣdia:Gecorene gemynddagas/22 Æfterra Gēola	Wikipédia:Éphéméride/22 janvier
Wikipǣdia:Gecorene gemynddagas/4 Æfterra Gēola	Wikipédia:Éphéméride/4 janvier
Wikipǣdia:Gecorene gemynddagas/4 Gēolmōnaþ	Wikipédia:Éphéméride/4 décembre
Wikipǣdia:Gecorene gemynddagas/24 Æfterra Gēola	Wikipédia:Éphéméride/24 janvier
Wikipǣdia:Brōðra rǣdscēawung	Wikipédia:Atelier de lecture
Bysen:Year nav	Modèle:Années
Flocc:Flyhthæfenan on Fietname	Catégorie:Aéroport au Viêt Nam
Bysen:Brūcend pl-1	Modèle:Utilisateur pl-1
Flocc:Cyningas of Englalande	Catégorie:Monarque d'Angleterre
Bysen:Brūcend fr-3	Modèle:Utilisateur fr-3
Bysen:Imdb name	Modèle:Imdb nom
Flocc:Tunisia	Catégorie:Tunisie
Bysen:Cyþþubox Ira tun	Modèle:Infobox Ville d'Irlande
Bysen:Brūcend lt	Modèle:Utilisateur lt
Bysen:Oppose	Modèle:Contre
Bysen:Coord/link	Modèle:Coord/link
Bysen:Infobox UK place	Modèle:Infobox Ville du Royaume-Uni
Bysen:Brūcend de-5	Modèle:Utilisateur de-5
Bysen:Brūcend is-1	Modèle:Utilisateur is-1
Bysen:Brūcend is-2	Modèle:Utilisateur is-2
Bysen:Brūcend is	Modèle:Utilisateur is
Bysen:Brūcend de-0	Modèle:Utilisateur de-0
Bysen:Brūcend fr-5	Modèle:Utilisateur fr-5
Bysen:Brūcend en-5	Modèle:Utilisateur en-5
Bysen:Dagas þǣre wuce	Modèle:Palette Jours de la semaine
Bysen:Brūcend fr-0	Modèle:Utilisateur fr-0
Flocc:Norþ Carolīna	Catégorie:Caroline du Nord
Flocc:Puerto Rico	Catégorie:Porto Rico
Flocc:Byrig þāra Geāndena Rīca American	Catégorie:Ville des États-Unis
Bysen:Country data West Germany	Modèle:Country data Allemagne de l'Ouest
Bysen:Lang-ru	Modèle:Lang-ru
Bysen:Country data East Germany	Modèle:Country data Allemagne de l'Est
Bysen:Brūcend it-0	Modèle:Utilisateur it-0
Bysen:Browsebar	Modèle:Browsebar
Flocc:Brittisca Here	Catégorie:Armée de terre britannique
Bysen:Disambig	Modèle:Homonymie
Flocc:Byrig on Israhēlum	Catégorie:Localité d'Israël
Bysen:Country data Nazi Germany	Modèle:Country data Allemagne nazie
Bysen:Doi	Modèle:Doi
Bysen:Country data German Empire	Modèle:Country data Empire allemand
Flocc:Coreanisc stǣr	Catégorie:Histoire de la Corée
Bysen:Lang-grc	Modèle:Lang-grc
Bysen:Brūcend ksh	Modèle:Utilisateur ksh
Bysen:Infobox Film	Modèle:Infobox Cinéma (film)
Bysen:Lang-en	Modèle:Lang-en
Flocc:Byrig on Oklahoman	Catégorie:Localité de l'Oklahoma
Bysen:Lang-id	Modèle:Lang-id
Bysen:Monþes lengþ	Modèle:MONTHDAYS
Flocc:Byrig on Belgum	Catégorie:Localité de Belgique
Bysen:Brūcend sv-2	Modèle:Utilisateur sv-2
Bysen:Brūcend it-2	Modèle:Utilisateur it-2
Bysen:Lang-fr	Modèle:En français
Flocc:Angelseaxisc Englaland	Catégorie:Anglo-Saxons
Bysen:Fossil range	Modèle:Présence fossile
Bysen:Brūcend pt-0	Modèle:Utilisateur pt-0
Bysen:Editnotice	Modèle:Notice d'édition
Bysen:Betwuxwici	Modèle:Interwiki
Wikipǣdia:Gecorene gemynddagas/Hāligmōnaþ	Wikipédia:Éphéméride/septembre
Bysen:Coord	Modèle:Coord
Bysen:Brūcend pt-3	Modèle:Utilisateur pt-3
Flocc:Byrig on Lincolnscīre	Catégorie:Ville du Lincolnshire
Bysen:TemplatePAGENAME	Modèle:ModèlePAGENAME
Bysen:Brūcend pt-2	Modèle:Utilisateur pt-2
Flocc:Wyoming	Catégorie:Wyoming
Wikipǣdia:Gecorene gemynddagas/1 Æfterra Gēola	Wikipédia:Éphéméride/1 janvier
Wikipǣdia:Gecorene gemynddagas/6 Gēolmōnaþ	Wikipédia:Éphéméride/6 décembre
Bysen:Brūcend fr-4	Modèle:Utilisateur fr-4
Flocc:Grēneland	Catégorie:Groenland
Wikipǣdia:Gecorene gemynddagas/Winterfylleþ	Wikipédia:Éphéméride/octobre
Bysen:Brūcend la-1	Modèle:Utilisateur la-1
Bysen:Land on Europan	Modèle:Palette Pays d'Europe
Bysen:Brūcend is-0	Modèle:Utilisateur is-0
Bysen:Brūcend el-0	Modèle:Utilisateur el-0
Flocc:User sk	Catégorie:Utilisateur sk
Flocc:Brūcend eo	Catégorie:Utilisateur eo
Flocc:Brūcend fr	Catégorie:Utilisateur fr
Flocc:Brūcend cy	Catégorie:Utilisateur cy
Flocc:Brūcend got	Catégorie:Utilisateur got
Flocc:Brūcend ang	Catégorie:Utilisateur ang
Flocc:Brūcend la	Catégorie:Utilisateur la
Flocc:Brūcend lt	Catégorie:Utilisateur lt
Flocc:Brūcend pt	Catégorie:Utilisateur pt
Flocc:Brūcend sv	Catégorie:Utilisateur sv
Flocc:Brūcend fr-3	Catégorie:Utilisateur fr-3
Flocc:Brūcend cy-3	Catégorie:Utilisateur cy-3
Flocc:Brūcend ang-3	Catégorie:Utilisateur ang-3
Flocc:Brūcend it-3	Catégorie:Utilisateur it-3
Flocc:Brūcend pl-3	Catégorie:Utilisateur pl-3
Flocc:Brūcend fi-1	Catégorie:Utilisateur fi-1
Flocc:Brūcend cy-1	Catégorie:Utilisateur cy-1
Flocc:Brūcend ang-1	Catégorie:Utilisateur ang-1
Flocc:Brūcend nl-1	Catégorie:Utilisateur nl-1
Flocc:Brūcend pl-1	Catégorie:Utilisateur pl-1
Flocc:Brūcend fr-4	Catégorie:Utilisateur fr-4
Flocc:Brūcend cy-4	Catégorie:Utilisateur cy-4
Flocc:Brūcend ang-4	Catégorie:Utilisateur ang-4
Flocc:Brūcend it-4	Catégorie:Utilisateur it-4
Flocc:Brūcend pl-4	Catégorie:Utilisateur pl-4
Flocc:Brūcend fr-2	Catégorie:Utilisateur fr-2
Flocc:Brūcend cy-2	Catégorie:Utilisateur cy-2
Flocc:Brūcend ang-2	Catégorie:Utilisateur ang-2
Flocc:Brūcend it-2	Catégorie:Utilisateur it-2
Flocc:Brūcend la-2	Catégorie:Utilisateur la-2
Flocc:Brūcend pl-2	Catégorie:Utilisateur pl-2
Flocc:Brūcend sv-2	Catégorie:Utilisateur sv-2
Flocc:Brūcend fr-M	Catégorie:Utilisateur fr-M
Flocc:Brūcend cy-M	Catégorie:Utilisateur cy-M
Flocc:Brūcend ang-N	Catégorie:Utilisateur ang-M
Flocc:Brūcend is-M	Catégorie:Utilisateur is-M
Flocc:Brūcend lt-N	Catégorie:Utilisateur lt-M
Flocc:Brūcend nl-M	Catégorie:Utilisateur nl-M
Flocc:Brūcend ru-M	Catégorie:Utilisateur ru-M
Flocc:Brūcend fr-5	Catégorie:Utilisateur fr-5
Flocc:Brūcend it-5	Catégorie:Utilisateur it-5
Flocc:Feormung	Catégorie:Divertissement
Flocc:Hēafodstōlas þæs Sericus Gārsecges	Catégorie:Capitale d'Océanie
Flocc:Law & Order	Catégorie:Law and Order
Flocc:Turcas and Caicos Īegland	Catégorie:Îles Turques-et-Caïques
Flocc:Tudoryld	Catégorie:Angleterre des Tudor
Bysen:Sūþhjaltland	Modèle:Palette Îles Shetland du Sud
Flocc:Articles that need to be wikified	Catégorie:Article à wikifier
Flocc:Īega	Catégorie:Île
Flocc:Sericus Garsecg	Catégorie:Océan Pacifique
Flocc:User sk-N	Catégorie:Utilisateur sk-M
Flocc:Brūcend de	Catégorie:Utilisateur de
Flocc:Brūcend de-2	Catégorie:Utilisateur de-2
Flocc:Brūcend de-3	Catégorie:Utilisateur de-3
Flocc:Brūcend de-4	Catégorie:Utilisateur de-4
Flocc:Brūcend el	Catégorie:Utilisateur el
Flocc:Brūcend el-1	Catégorie:Utilisateur el-1
Flocc:Brūcend el-2	Catégorie:Utilisateur el-2
Flocc:Brūcend el-3	Catégorie:Utilisateur el-3
Flocc:Brūcend el-4	Catégorie:Utilisateur el-4
Flocc:Brūcend el-N	Catégorie:Utilisateur el-M
Flocc:Sūþgeorgia and þā Sūþsandwic Īegland	Catégorie:Géorgie du Sud-et-les Îles Sandwich du Sud
Flocc:Brūcend en-3	Catégorie:Utilisateur en-3
Flocc:Brūcend en-5	Catégorie:Utilisateur en-5
Flocc:Brūcend en-M	Catégorie:Utilisateur en-M
Flocc:Brūcend eo-2	Catégorie:Utilisateur eo-2
Flocc:Brūcend es	Catégorie:Utilisateur es
Flocc:Brūcend es-1	Catégorie:Utilisateur es-1
Flocc:Brūcend es-2	Catégorie:Utilisateur es-2
Flocc:Puilla	Catégorie:Pouilles
Flocc:Brūcend es-3	Catégorie:Utilisateur es-3
Flocc:Brūcend es-4	Catégorie:Utilisateur es-4
Bysen:Brūcend es-5	Modèle:Utilisateur es-5
Flocc:Brūcend es-N	Catégorie:Utilisateur es-M
Flocc:Brūcend fi	Catégorie:Utilisateur fi
Flocc:Brūcend fi-M	Catégorie:Utilisateur fi-M
Flocc:Brūcend fo	Catégorie:Utilisateur fo
Flocc:Brūcend fo-1	Catégorie:Utilisateur fo-1
Flocc:Brūcend fo-2	Catégorie:Utilisateur fo-2
Flocc:Brūcend fo-4	Catégorie:Utilisateur fo-4
Flocc:Brūcend fo-M	Catégorie:Utilisateur fo-M
Flocc:Brūcend is	Catégorie:Utilisateur is
Flocc:Brūcend is-1	Catégorie:Utilisateur is-1
Flocc:Brūcend is-2	Catégorie:Utilisateur is-2
Flocc:Brūcend is-3	Catégorie:Utilisateur is-3
Flocc:Brūcend is-4	Catégorie:Utilisateur is-4
Flocc:Brūcend is-5	Catégorie:Utilisateur is-5
Flocc:Mexiciscu rīce	Catégorie:Subdivision du Mexique
Bysen:Brūcend la-3	Modèle:Utilisateur la-3
Flocc:Frencisc Guiana	Catégorie:Guyane
Ǣht	Propriété
Flocc:Hebrēisc sprǣc	Catégorie:Langue hébraïque
Flocc:Brūcend pt-3	Catégorie:Utilisateur pt-3
Flocc:Bryttisc bōccræft	Catégorie:Littérature britannique
Flocc:Brūcend pl-N	Catégorie:Utilisateur pl-M
Flocc:Brūcend pt-1	Catégorie:Utilisateur pt-1
Bysen:Country data Germany	Modèle:Country data Allemagne
Bysen:Country data Geāned Cynerīce	Modèle:Country data Royaume-Uni
Wikipǣdia:Gecorene gemynddagas/Mǣdmōnaþ	Wikipédia:Éphéméride/juillet
Bysen:Lang-be	Modèle:Lang-be
Bysen:Cite encyclopedia	Modèle:Cite encyclopedia
Bysen:Country data Scotland	Modèle:Country data Écosse
Flocc:Brūcend it	Catégorie:Utilisateur it
Flocc:Brūcend it-1	Catégorie:Utilisateur it-1
Flocc:Rīcu þāra Geāndena Rīca American	Catégorie:État des États-Unis
Flocc:Brūcend ksh	Catégorie:Utilisateur ksh
Bysen:Mpl	Modèle:PM1
Flocc:Brūcend la-1	Catégorie:Utilisateur la-1
Flocc:Brūcend la-3	Catégorie:Utilisateur la-3
Flocc:Brūcend la-4	Catégorie:Utilisateur la-4
Flocc:Brūcend la-N	Catégorie:Utilisateur la-M
Flocc:Byrig on Īslande	Catégorie:Localité d'Islande
Bysen:Cite doi	Modèle:Citer doi
Flocc:Pulgara cyningas	Catégorie:Souverain de Bulgarie
Flocc:Fȳrbeorgas	Catégorie:Volcan
Flocc:Dēorabyscīr	Catégorie:Derbyshire
Flocc:Byrig on Latie	Catégorie:Commune de la région Latium
Bysen:Englaland Scīra	Modèle:Palette Comtés d'Angleterre
Flocc:Feohtan	Catégorie:Art martial
Bysen:Country data Australasia	Modèle:Country data Australasie
Flocc:Blōtmōnaþ	Catégorie:Novembre
Flocc:Difelinscīr	Catégorie:Comté de Dublin
Wikipǣdia:Babel	Wikipédia:Babel
Bysen:Help contents back	Modèle:Retour au sommaire de l'aide
Flocc:Scopas	Catégorie:Poète
Flocc:Hāligmōnaþ	Catégorie:Septembre
Flocc:Byrig on Norþdakotan	Catégorie:Localité du Dakota du Nord
Flocc:Winterfylleþ	Catégorie:Octobre
Flocc:Sǣ	Catégorie:Mer
Flocc:Gēolmōnaþ	Catégorie:Décembre
Flocc:Wēodmōnaþ	Catégorie:Août
Flocc:Þrimilcemōnaþ	Catégorie:Mai
Flocc:Brandenburg	Catégorie:Brandebourg
Flocc:Englaland	Catégorie:Angleterre
Flocc:Ēastermōnaþ	Catégorie:Avril
Bysen:IPA2	Modèle:API-
Flocc:Līfnamrǣden	Catégorie:Taxinomie
Bysen:Lang-it	Modèle:Lang-it
Bysen:Coord/dms2dec	Modèle:Coord/dms2dec
Flocc:Brūcend es-5	Catégorie:Utilisateur es-5
Bysen:Country data Brazil	Modèle:Country data Brésil
Flocc:Gestorfen in 988	Catégorie:Décès en 988
Flocc:Wæter	Catégorie:Eau
Flocc:Hēafod and swēor	Catégorie:Tête et cou
Flocc:Geboren in 121	Catégorie:Naissance en 121
Wikipǣdia:MediaWiki namespace	Aide:Message système
Bysen:Lang-mi	Modèle:Lang-mi
Flocc:180	Catégorie:180
Flocc:Gestorfen in 180	Catégorie:Décès en 180
Flocc:Drincas	Catégorie:Boisson
Flocc:Gestorfen in 2005	Catégorie:Décès en 2005
Flocc:450	Catégorie:450
Bysen:Start date and age	Modèle:Existe depuis
Wikipǣdia:Manigsprǣclicu samodwyrcung	Wikipédia:Coordination multilingue
Flocc:Geboren in 1974	Catégorie:Naissance en 1974
Flocc:Geboren in 1899	Catégorie:Naissance en 1899
Flocc:Oklahoma	Catégorie:Oklahoma
Flocc:Iapanisc sangeras	Catégorie:Chanteur japonais
Flocc:Geboren in 1954	Catégorie:Naissance en 1954
Flocc:850	Catégorie:850
Flocc:Geboren in 850	Catégorie:Naissance en 850
Flocc:Hwītrussland	Catégorie:Biélorussie
Flocc:Alberta	Catégorie:Alberta
Flocc:Ontario	Catégorie:Ontario
Flocc:Nīwe Scotland	Catégorie:Nouvelle-Écosse
Flocc:899	Catégorie:899
Flocc:Gestorfen in 899	Catégorie:Décès en 899
Flocc:Geocon Landscipe	Catégorie:Yukon
Flocc:Massachusetts	Catégorie:Massachusetts
Flocc:924	Catégorie:924
Flocc:Gestorfen in 924	Catégorie:Décès en 924
Bysen:Brūcend ang-0	Modèle:Utilisateur ang-0
Bysen:Country data Ungerland	Modèle:Country data Hongrie
Flocc:Land on Affrice	Catégorie:Pays d'Afrique
Bysen:Canadan underrīce	Modèle:Palette Provinces et territoires du Canada
Bysen:Template reference list	Modèle:Références du modèle
Flocc:Geboren in 1239	Catégorie:Naissance en 1239
Flocc:1249	Catégorie:1249
Bysen:Brūcend la-0	Modèle:Utilisateur la-0
Flocc:1289	Catégorie:1289
Flocc:1305	Catégorie:1305
Flocc:Gestorfen in 1305	Catégorie:Décès en 1305
Flocc:1307	Catégorie:1307
Wikipǣdia:Gecorene gemynddagas/Blōtmōnaþ	Wikipédia:Éphéméride/novembre
Bysen:Brūcend pt-4	Modèle:Utilisateur pt-4
Bysen:Country data New Zealand	Modèle:Country data Nouvelle-Zélande
Bysen:Brūcend es-3	Modèle:Utilisateur es-3
Flocc:Ēa Franclandes	Catégorie:Cours d'eau de France
Flocc:Brūcend pt-2	Catégorie:Utilisateur pt-2
Flocc:Brūcend pt-4	Catégorie:Utilisateur pt-4
Flocc:Brūcend pt-5	Catégorie:Utilisateur pt-5
Flocc:Brūcend pt-N	Catégorie:Utilisateur pt-M
Flocc:Brūcend ru	Catégorie:Utilisateur ru
Flocc:Brūcend sv-M	Catégorie:Utilisateur sv-M
Flocc:1634	Catégorie:1634
Flocc:1638	Catégorie:1638
Bysen:En icon	Modèle:En
Flocc:1719	Catégorie:1719
Flocc:Gestorfen in 1719	Catégorie:Décès en 1719
Bysen:Country data Faroe Islands	Modèle:Country data Îles Féroé
Flocc:121	Catégorie:121
Bysen:Lang	Modèle:Langue
Bysen:Country data Americanisc	Modèle:Country data États-Unis
Bysen:Template example row	Modèle:Ligne d'exemple de modèle
Flocc:Trēowu	Catégorie:Arbre
Bysen:Infobox ea	Modèle:Infobox Cours d'eau
Flocc:Geboren in 1634	Catégorie:Naissance en 1634
Flocc:Geboren in 1638	Catégorie:Naissance en 1638
Flocc:Geboren in 1852	Catégorie:Naissance en 1852
Flocc:Geboren in 1892	Catégorie:Naissance en 1892
Flocc:Geboren in 1918	Catégorie:Naissance en 1918
Flocc:Geboren in 1945	Catégorie:Naissance en 1945
Flocc:Geboren in 1949	Catégorie:Naissance en 1949
Flocc:Geboren in 1981	Catégorie:Naissance en 1981
Flocc:Geboren in 1993	Catégorie:Naissance en 1993
Flocc:1715	Catégorie:1715
Wikipǣdia:Gecorene gemynddagas/Ēastermōnaþ	Wikipédia:Éphéméride/avril
Bysen:Period color	Modèle:Couleur stratigraphique
Flocc:11e gēarhundred	Catégorie:XIe siècle
Flocc:988	Catégorie:988
Flocc:10e gēarhundred	Catégorie:Xe siècle
Flocc:7e gēarhundred	Catégorie:VIIe siècle
Flocc:1239	Catégorie:1239
Flocc:Gestorfen in 1307	Catégorie:Décès en 1307
Flocc:Corsica	Catégorie:Corse
Flocc:Gestorfen in 1715	Catégorie:Décès en 1715
Flocc:Russisce bōccræft	Catégorie:Littérature russe
Flocc:Sardinia	Catégorie:Sardaigne
Bysen:Lang-hi	Modèle:Lang-hi
Flocc:Florida	Catégorie:Floride
Flocc:Normandig	Catégorie:Normandie
Bysen:Coord/dec2dms/dm	Modèle:Coord/dec2dms/dm
Flocc:Francena caseras	Catégorie:Empereur des Français
Flocc:Nevada	Catégorie:Nevada
Flocc:Nebraska	Catégorie:Nebraska
Flocc:Norþ Dakota	Catégorie:Dakota du Nord
Flocc:Nīwe Eoforwīc	Catégorie:État de New York
Flocc:Rhode Īeg	Catégorie:Rhode Island
Flocc:Louisiāna	Catégorie:Louisiane
Flocc:Marianland	Catégorie:Maryland
Flocc:Maine	Catégorie:Maine
Flocc:Minnesota	Catégorie:Minnesota
Flocc:Michigan	Catégorie:Michigan
Flocc:Mississippi	Catégorie:Mississippi
Flocc:Missouri	Catégorie:Missouri
Flocc:Vermont	Catégorie:Vermont
Flocc:Virginia	Catégorie:Virginie
Flocc:Idaho	Catégorie:Idaho
Flocc:Iowa	Catégorie:Iowa
Flocc:Arkansas	Catégorie:Arkansas
Flocc:Alaska	Catégorie:Alaska
Flocc:Arizona	Catégorie:Arizona
Flocc:Alabama	Catégorie:Alabama
Flocc:Ohio	Catégorie:Ohio
Flocc:Westvirginia	Catégorie:Virginie-Occidentale
Flocc:Wisconsin	Catégorie:Wisconsin
Flocc:Indiāna	Catégorie:Indiana
Flocc:Illinois	Catégorie:Illinois
Flocc:Kansas	Catégorie:Kansas
Flocc:California	Catégorie:Californie
Flocc:Kentucky	Catégorie:Kentucky
Flocc:Connecticut	Catégorie:Connecticut
Flocc:Colorado	Catégorie:Colorado
Flocc:Texas	Catégorie:Texas
Flocc:Hawaii	Catégorie:Hawaï
Bysen:Fs end	Modèle:Fs end
Bysen:Fs start	Modèle:Fs start
Flocc:Ōðru Woruldgūþ	Catégorie:Seconde Guerre mondiale
Flocc:Nīwes Sǣlandes byrig	Catégorie:Localité de Nouvelle-Zélande
Flocc:Hundas	Catégorie:Chien
Flocc:Cattas	Catégorie:Felidae
Wikipǣdia:Gecorene gemynddagas/16 Solmōnaþ	Wikipédia:Éphéméride/16 février
Flocc:Russisce wrīteras	Catégorie:Écrivain russe
Bysen:•	Modèle:•
Flocc:1066	Catégorie:1066
Flocc:Gestorfen in 1066	Catégorie:Décès en 1066
Flocc:Angola	Catégorie:Angola
Flocc:Botswana	Catégorie:Botswana
Flocc:Elpendbānrima	Catégorie:Côte d'Ivoire
Flocc:Æriþrea	Catégorie:Érythrée
Flocc:Gabon	Catégorie:Gabon
Flocc:Gambia	Catégorie:Gambie
Flocc:Guinea	Catégorie:Guinée
Flocc:Camerun	Catégorie:Cameroun
Flocc:Grēnenæs Īega	Catégorie:Cap-Vert
Flocc:Cenia	Catégorie:Kenya
Flocc:Liberia	Catégorie:Liberia
Flocc:Libia	Catégorie:Libye
Flocc:Morocco	Catégorie:Maroc
Flocc:Mauritania	Catégorie:Mauritanie
Flocc:1451	Catégorie:1451
Flocc:Namibia	Catégorie:Namibie
Flocc:Caribisc Sǣ	Catégorie:Mer des Caraïbes
Flocc:Delaware	Catégorie:Delaware
Flocc:Georgia (America)	Catégorie:Géorgie (États-Unis)
Flocc:Montāna	Catégorie:Montana
Flocc:Eall gewritu þe hlȳtrunge þurfaþ	Catégorie:Article à recycler
Bysen:Merge	Modèle:À fusionner
Flocc:Tennessee	Catégorie:Tennessee
Flocc:Baden-Wyrttemberg	Catégorie:Bade-Wurtemberg
Flocc:1852	Catégorie:1852
Flocc:1892	Catégorie:1892
Flocc:Gestorfen in 1926	Catégorie:Décès en 1926
Flocc:1973	Catégorie:1973
Flocc:Gestorfen in 1973	Catégorie:Décès en 1973
Flocc:1975	Catégorie:1975
Flocc:1981	Catégorie:1981
Flocc:Gestorfen in 1982	Catégorie:Décès en 1982
Flocc:2004	Catégorie:2004
Flocc:Gestorfen in 2004	Catégorie:Décès en 2004
Flocc:2005	Catégorie:2005
Flocc:2006	Catégorie:2006
Flocc:2007	Catégorie:2007
Flocc:2008	Catégorie:2008
Flocc:Ēa	Catégorie:Rivière
Bysen:Brūcend el-2	Modèle:Utilisateur el-2
Bysen:Brūcend fo-1	Modèle:Utilisateur fo-1
Bysen:Brūcend fo-3	Modèle:Utilisateur fo-3
Bysen:Brūcend la-2	Modèle:Utilisateur la-2
Bysen:Brūcend no-1	Modèle:Utilisateur no-1
Bysen:Brūcend pl-2	Modèle:Utilisateur pl-2
Bysen:Brūcend pt	Modèle:Utilisateur pt
Flocc:Sūþsudan	Catégorie:Soudan du Sud
Flocc:Cead	Catégorie:Tchad
Flocc:Uganda	Catégorie:Ouganda
Flocc:Rōmānisce Cāseras	Catégorie:Empereur romain
Flocc:Brūcend nl	Catégorie:Utilisateur nl
Flocc:Sūþhjaltland	Catégorie:Îles Shetland du Sud
Flocc:Brūcend no-1	Catégorie:Utilisateur no-1
Flocc:Brūcend no-2	Catégorie:Utilisateur no-2
Flocc:Brūcend no	Catégorie:Utilisateur no
Flocc:Niðerlanda Cyningas	Catégorie:Roi des Pays-Bas
Flocc:Norrena cyningas	Catégorie:Monarque de Norvège
Flocc:Swēona cyningas	Catégorie:Roi de Suède
Flocc:Armenia	Catégorie:Arménie
Flocc:Bahrain	Catégorie:Bahreïn
Flocc:Mennisc bodiȝlār	Catégorie:Anatomie humaine
Flocc:Feorrsīen	Catégorie:Télévision
Flocc:Angelcirice	Catégorie:Église d'Angleterre
Flocc:14e gēarhundred	Catégorie:XIVe siècle
Flocc:13e gēarhundred	Catégorie:XIIIe siècle
Flocc:2e gēarhundred	Catégorie:IIe siècle
Flocc:4e gēarhundred	Catégorie:IVe siècle
Flocc:5e gēarhundred	Catégorie:Ve siècle
Flocc:18e gēarhundred	Catégorie:XVIIIe siècle
Flocc:6e gēarhundred	Catégorie:VIe siècle
Flocc:Arabea	Catégorie:Arabie
Flocc:Nīwlicu Word	Catégorie:Néologisme
Flocc:Nīwesǣlendisce wrīteras	Catégorie:Écrivain néo-zélandais
Flocc:Seaxland-Anhalt	Catégorie:Saxe-Anhalt
Flocc:Niðerseaxland	Catégorie:Basse-Saxe
Flocc:Russe	Catégorie:Personnalité russe
Flocc:Unƿǣre lēode	Catégorie:Personnage de fiction
Flocc:Crēcisc ūtwitan	Catégorie:Philosophe grec
Flocc:Sūþseaxe	Catégorie:Sussex
Flocc:Bægwaraland	Catégorie:Bavière
Flocc:Superman	Catégorie:Superman
Flocc:Ēage	Catégorie:Œil
Flocc:Corn	Catégorie:Céréale
Flocc:Nīweoforwīcburg	Catégorie:New York
Flocc:Norþfolc	Catégorie:Norfolk
Flocc:Norþhāmtūnescīr	Catégorie:Northamptonshire
Flocc:NBC	Catégorie:National Broadcasting Company
Flocc:Gamen	Catégorie:Loisir
Flocc:Snotingahāmscīr	Catégorie:Nottinghamshire
Flocc:15e gēarhundred	Catégorie:XVe siècle
Flocc:Georgia (land)	Catégorie:Géorgie
Flocc:Cambodia	Catégorie:Cambodge
Flocc:Americanisc sangeras	Catégorie:Chanteur américain
Flocc:Bryttisce scopas	Catégorie:Poète britannique
Flocc:Stǣr þæs Cynerices Greatbryttenes	Catégorie:Histoire du Royaume-Uni
Flocc:Iamaica	Catégorie:Jamaïque
Bysen:Lang-hy	Modèle:Lang-hy
Flocc:Scotta cyningas	Catégorie:Monarque d'Écosse
Flocc:Bryttiscan Fæmne Īegland	Catégorie:Îles Vierges britanniques
Flocc:Corēa	Catégorie:Corée
Flocc:Burma	Catégorie:Birmanie
Flocc:Taprabane	Catégorie:Sri Lanka
Flocc:Tacgicastan	Catégorie:Tadjikistan
Flocc:Ēasttimor	Catégorie:Timor oriental
Flocc:Turcmenistan	Catégorie:Turkménistan
Flocc:Usbecastan	Catégorie:Ouzbékistan
Flocc:Geānedan Arabiscan Bregorīce	Catégorie:Émirats arabes unis
Flocc:9e gēarhundred	Catégorie:IXe siècle
Flocc:Sofiet Gesamnung	Catégorie:URSS
Bysen:Bēc þǣre Ealdan Gecȳþnesse	Modèle:Palette Livres de l'Ancien Testament
Wikipǣdia:Sēðung þurfed	Aide:Citation nécessaire
Bysen:Brūcend de-4	Modèle:Utilisateur de-4
Flocc:Searwa stycce	Catégorie:Wikipédia:ébauche technique
Flocc:Wēalas	Catégorie:Pays de Galles
Flocc:Blizzard Entertainment	Catégorie:Blizzard Entertainment
Flocc:Foresittendas þāra Geāndena Rīca American	Catégorie:Président des États-Unis
Flocc:Europisc stǣr	Catégorie:Histoire de l'Europe
Flocc:Hascemisce Cynerīce þæs Iordanes	Catégorie:Jordanie
Flocc:Bosnia and Herzegovina	Catégorie:Bosnie-Herzégovine
Flocc:Norþweg	Catégorie:Norvège
Flocc:Barbados	Catégorie:Barbade
Flocc:Paraguay	Catégorie:Paraguay
Flocc:Ficgiege	Catégorie:Fidji
Flocc:Lēohtenstān	Catégorie:Liechtenstein
Flocc:Uruguay	Catégorie:Uruguay
Flocc:Andorra	Catégorie:Andorre
Flocc:Serbia	Catégorie:Serbie
Flocc:Ecuador	Catégorie:Équateur
Flocc:Peru	Catégorie:Pérou
Flocc:Bolifia	Catégorie:Bolivie
Flocc:Albania	Catégorie:Albanie
Flocc:Monaco	Catégorie:Monaco
Flocc:Land on Norðamerican	Catégorie:Pays d'Amérique du Nord
Flocc:Fiscas	Catégorie:Poisson
Flocc:Mūþ	Catégorie:Bouche
Flocc:Wyrta	Catégorie:Légume
Flocc:Ofet	Catégorie:Fruit alimentaire
Flocc:Nīwu Gecȳþnes	Catégorie:Nouveau Testament
Flocc:Musea	Catégorie:Musée
Flocc:Landscipas Swēolandes	Catégorie:Comté de Suède
Flocc:Stǣrlice Sprǣccræft	Catégorie:Linguistique historique
Flocc:Dūnholmscīr	Catégorie:Durham
Flocc:Manga	Catégorie:Manga
Flocc:Eoferwicscīr	Catégorie:Yorkshire
Flocc:Oferhæleðas	Catégorie:Super-héros
Flocc:Calpis	Catégorie:Gibraltar
Flocc:Beadwe	Catégorie:Bataille
Flocc:Weorcendebyrdnessa	Catégorie:Système d'exploitation
Flocc:Mexicorīce	Catégorie:État du Mexique
Flocc:Hidalgo Rīce	Catégorie:État d'Hidalgo
Flocc:Hetwaraland	Catégorie:Hesse
Flocc:Canadan underrīce and landscipas	Catégorie:Province ou territoire canadien
Flocc:Lunden	Catégorie:Londres
Flocc:Lincolnscīr	Catégorie:Lincolnshire
Flocc:Hēafodstōlas in American	Catégorie:Ville d'Amérique
Bysen:Incubator	Modèle:Incubator
Flocc:Dæg þæs gēares	Catégorie:Jour de l'année
Flocc:Wikimedian geweorc	Catégorie:Wikimedia
Flocc:Byrig on Buccingahamscīre	Catégorie:Ville du Buckinghamshire
Flocc:Wiltūnscīr	Catégorie:Wiltshire
Flocc:Wigreceastrescīr	Catégorie:Worcestershire
Flocc:Americanisce Ingefeoht	Catégorie:Guerre de Sécession
Flocc:Byrig on Tuscanie	Catégorie:Commune de la région Toscane
Flocc:Wyrt	Catégorie:Plante condimentaire
Flocc:Dēor	Catégorie:Animal
Flocc:Hweorfdēor	Catégorie:Vertébré
Flocc:Pitcearnīega	Catégorie:Îles Pitcairn
Flocc:Cægman Īegland	Catégorie:Îles Caïmans
Flocc:Folcland Īegland	Catégorie:Îles Malouines
Flocc:Land on Sūðamerican	Catégorie:Pays d'Amérique du Sud
Flocc:Colombia	Catégorie:Colombie
Bysen:End box	Modèle:S-end
Flocc:Anime	Catégorie:Anime
Flocc:Oxnafordscīr	Catégorie:Oxfordshire
Flocc:Hociȝ	Catégorie:Hockey
Flocc:Heortfordscīr	Catégorie:Hertfordshire
Flocc:Sicilia	Catégorie:Sicile
Flocc:Grantabrycgscīr	Catégorie:Cambridgeshire
Flocc:Þēodacynewīse	Catégorie:Commonwealth
Flocc:Līþ	Catégorie:Boisson alcoolisée
Flocc:Spearctellas	Catégorie:Console de jeux vidéo
Flocc:Englisc scīr	Catégorie:Comté d'Angleterre
Flocc:Æþelingas	Catégorie:Prince
Flocc:Ceasterscīr	Catégorie:Cheshire
Flocc:Sūþrige	Catégorie:Surrey
Flocc:Defenascīr	Catégorie:Devon
Flocc:Se Hlāford þāra Hringa	Catégorie:Le Seigneur des anneaux
Flocc:Rōmāniscu Folclār	Catégorie:Mythologie romaine
Flocc:Beadanfordscīr	Catégorie:Bedfordshire
Flocc:Bēor	Catégorie:Bière
Flocc:Sang	Catégorie:Chanson
Flocc:Hēafodstōlas	Catégorie:Capitale de pays
Flocc:Stōwlice hēafodstōlas Canadan	Catégorie:Ville du Canada
Flocc:Ēastseaxe	Catégorie:Essex
Flocc:Middelasia	Catégorie:Asie centrale
Flocc:Indisca Underworulddǣl	Catégorie:Monde indien
Flocc:NFL	Catégorie:National Football League
Flocc:Tuscania	Catégorie:Toscane
Flocc:Latium	Catégorie:Latium
Flocc:Lonceasterscīr	Catégorie:Lancashire
Flocc:Hāmtūnescīr	Catégorie:Hampshire
Flocc:Brūcend pl	Catégorie:Utilisateur pl
Flocc:Gleawcesterscīr	Catégorie:Gloucestershire
Flocc:Rōmānisca sprǣca	Catégorie:Langue romane
Flocc:Fōr	Catégorie:Transport
Flocc:Sund	Catégorie:Natation
Flocc:Hēapplegan	Catégorie:Sport collectif
Flocc:Toys	Catégorie:Jouet
Flocc:Hīwscipe	Catégorie:Famille
Flocc:Cornweall	Catégorie:Cornouailles
Flocc:Cīna Caseras	Catégorie:Empereur de Chine
Flocc:Tūnas on Sūþfolce	Catégorie:Village du Suffolk
Flocc:Antarctica	Catégorie:Antarctique
Flocc:Norðamerica	Catégorie:Amérique du Nord
Flocc:Euxinus	Catégorie:Mer Noire
Flocc:Meras	Catégorie:Lac
Flocc:Byrig on Virginie	Catégorie:Localité de Virginie
Bysen:Country data Weimar Republic	Modèle:Country data République de Weimar
Flocc:Sweartbeorg	Catégorie:Monténégro
Flocc:Indisc Gārsecg	Catégorie:Océan Indien
Flocc:Wægnas	Catégorie:Automobile
Bysen:Brūcend af-2	Modèle:Utilisateur af-2
Wealhmoru	Carotte
Flocc:Byrig on Francum	Catégorie:Ville ou commune de France
Flocc:Cent	Catégorie:Kent
Flocc:Byrig on Fietname	Catégorie:Ville du Viêt Nam
Flocc:Byrig on þǣm Ucrægnan	Catégorie:Ville d'Ukraine
Flocc:Byrig on Eotolwarum	Catégorie:Ville d'Italie
Flocc:Beorgas on Brettum	Catégorie:Montagne du Royaume-Uni
Flocc:Scotland	Catégorie:Écosse
Flocc:Spēonisc bōccræft	Catégorie:Littérature espagnole
Flocc:Hēafodstōlas in Europe	Catégorie:Capitale européenne
Flocc:Hēafodstōlas in Asie	Catégorie:Capitale d'Asie
Flocc:Norðerne Īrland	Catégorie:Irlande du Nord
Flocc:Nīwesǣlendisc bōccræft	Catégorie:Littérature néo-zélandaise
Flocc:Īrisc bōccræft	Catégorie:Littérature irlandaise
Bysen:CompactTOC	Modèle:Compacttoc
Flocc:Geāsparedu līc	Catégorie:Momie
Flocc:Byrig on Californie	Catégorie:Localité de Californie
Flocc:Byrig on Uermonte	Catégorie:Localité du Vermont
Flocc:Byrig on Floridan	Catégorie:Localité de Floride
Flocc:Byrig on Illinoise	Catégorie:Localité de l'Illinois
Flocc:World Trade Center	Catégorie:World Trade Center
Flocc:Loidis	Catégorie:Leeds
Flocc:Australisc Hēafodburg Landscipe	Catégorie:Territoire de la capitale australienne
Flocc:Brūcend de-5	Catégorie:Utilisateur de-5
Bysen:Country data Cænada	Modèle:Country data Canada
Flocc:Angleseg	Catégorie:Île d'Anglesey
Bysen:Coord/dec2dms	Modèle:Coord/dec2dms
Bysen:Coord/dec2dms/dms	Modèle:Coord/dec2dms/dms
Bysen:Coord/display/inline	Modèle:Coord/display/inline
Bysen:Coord/input/d	Modèle:Coord/input/d
Bysen:Coord/input/dec	Modèle:Coord/input/dec
Bysen:Coord/input/dm	Modèle:Coord/input/dm
Bysen:Coord/input/dms	Modèle:Coord/input/dms
Bysen:Coord/prec dec	Modèle:Coord/prec dec
Flocc:Cyþþubox	Catégorie:Palette verticale
Bysen:Flag	Modèle:Pays
Bysen:Country data Barbados	Modèle:Country data Barbade
Bysen:Country data Empire of Japan	Modèle:Country data Empire du Japon
Bysen:Country data Martinique	Modèle:Country data Martinique
Bysen:Country data Åland Islands	Modèle:Country data Îles Åland
Bysen:Lang-pl	Modèle:Lang-pl
Bysen:Brūcend pl-3	Modèle:Utilisateur pl-3
Bysen:Brūcend pl-4	Modèle:Utilisateur pl-4
Flocc:Flæmingaland	Catégorie:Flandre
The Narrative	The Narrative
Flocc:Byrig on Difelinscīre	Catégorie:Ville du Comté de Dublin
Flocc:Ēastengla cyningas	Catégorie:Monarque d'Est-Anglie
Flocc:Miercna cyningas	Catégorie:Monarque de Mercie
Flocc:Norþhymbra cyningas	Catégorie:Monarque de Northumbrie
Flocc:Westseaxna cyningas	Catégorie:Monarque du Wessex
Trojany (Masovian Voivodship)	Trojany (Mazovie)
Flocc:Willelm Shakespeare	Catégorie:William Shakespeare
Flocc:Byrig þāra Faroiscan Īegena	Catégorie:Ville des îles Féroé
Flocc:Land on Asie	Catégorie:Pays d'Asie
Flocc:Windows gamen	Catégorie:Jeu Windows
Bysen:Dispute-resolution	Modèle:Palette Résolution de conflit
Bysen:Landskap	Modèle:Palette Landskap
Flocc:Wicibōceras in þǣm Geānlǣhtum Rīcum American	Catégorie:Utilisateur habite États-Unis
Bysen:Nigerie Rīce	Modèle:Palette États du Nigeria
Bysen:Brūcend la-4	Modèle:Utilisateur la-4
Bysen:Brūcend la	Modèle:Utilisateur la
Bysen:Brūcend it-4	Modèle:Utilisateur it-4
Bysen:Brūcend is-4	Modèle:Utilisateur is-4
Bysen:Brūcend is-3	Modèle:Utilisateur is-3
Bysen:Brūcend fo-2	Modèle:Utilisateur fo-2
Bysen:Brūcend fo	Modèle:Utilisateur fo
Bysen:Brūcend el-4	Modèle:Utilisateur el-4
Bysen:Brūcend el-3	Modèle:Utilisateur el-3
Bysen:Brūcend cy-3	Modèle:Utilisateur cy-3
Bysen:Brūcend cy-2	Modèle:Utilisateur cy-2
Bysen:Brūcend cy-1	Modèle:Utilisateur cy-1
Bysen:Brūcend cy	Modèle:Utilisateur cy
Bysen:Brūcend ang	Modèle:Utilisateur ang
Bysen:Lang-ti	Modèle:Lang-ti
Bysen:Lang-sq	Modèle:En albanais
Bysen:Lang-ro	Modèle:En roumain
Bysen:Lang-es	Modèle:Lang-es
Bysen:Lang-cy	Modèle:Lang-cy
Bysen:Lang-bn	Modèle:Lang-bn
Flocc:Westmidlandscīr	Catégorie:Midlands de l'Ouest (comté)
Flocc:West Loðene	Catégorie:West Lothian
Bysen:StarCraft endebyrdnes	Modèle:Palette StarCraft
Flocc:Wæringscīr	Catégorie:Warwickshire
Flocc:Tūnas on Norþhāmtūnescīre	Catégorie:Village du Northamptonshire
Flocc:Tūnas on Beadanfordscīre	Catégorie:Village du Bedfordshire
Flocc:Wīcinga Ieldu	Catégorie:Vikings
Wikipǣdia:Gecorene gemynddagas/Wēodmōnaþ	Wikipédia:Éphéméride/août
Flocc:Seolh	Catégorie:Pinnipède
Flocc:Engla cyningas	Catégorie:Monarque anglo-saxon
Flocc:Quebec	Catégorie:Québec
Flocc:Bryttisce ofersǣ landscipas	Catégorie:Territoire britannique d'outre-mer
Flocc:Ostsǣ	Catégorie:Mer Baltique
Flocc:Bysen Brūcend Box	Catégorie:Boîte utilisateur
Flocc:Dēaþstīele glīwdrēame clīwene	Catégorie:Groupe de death metal
Flocc:Clackmannanscīr	Catégorie:Clackmannanshire
Flocc:Gūþ	Catégorie:Guerre
Flocc:Ēast Loðene	Catégorie:East Lothian
Flocc:Fif Scīr	Catégorie:Fife
Flocc:Lēoðlic scātung	Catégorie:Patinage artistique
Bysen:Lang-fi	Modèle:En finnois
Bysen:Lang-sv	Modèle:Lang-sv
Flocc:Frencisc Polynesia	Catégorie:Polynésie française
Bysen:Brūcend it-5	Modèle:Utilisateur it-5
Flocc:Germanisca sprǣca	Catégorie:Langue germanique
Bysen:Precision1	Modèle:Precision1
Bysen:Precision/tz	Modèle:Precision/tz
Bysen:Precision/tz/1	Modèle:Precision/tz/1
Flocc:Hāmtūnscīr Scīr, West Virginia	Catégorie:Comté de Hampshire (Virginie-Occidentale)
Flocc:Herefordscīr	Catégorie:Herefordshire
Flocc:Rōmānisc stǣr	Catégorie:Histoire de Rome
Flocc:Huntandunscīr	Catégorie:Huntingdonshire
Flocc:Īshocig	Catégorie:Hockey sur glace
Wikipǣdia:Edit conflicts	Aide:Conflit de versions
Flocc:Īrland	Catégorie:Irlande (île)
Flocc:Constantinopolis	Catégorie:Istanbul
Wikipǣdia:Page history	Aide:Historique
Flocc:Mintan	Catégorie:Lamiaceae
Flocc:Bysen Sprǣc	Catégorie:Modèle de langue avec nom
Flocc:Lægreceastrescīr	Catégorie:Leicestershire
Flocc:Langbeardnaland	Catégorie:Lombardie
Wikipǣdia:Snellbred	Aide:Antisèche
Wikipǣdia:Sundortácnu	Aide:Caractères spéciaux
Flocc:Midloðene	Catégorie:Midlothian
Flocc:Rōwrenoc on Virginie	Catégorie:Roanoke (Virginie)
Flocc:Rōm	Catégorie:Rome
Flocc:Norþhymbraland	Catégorie:Northumberland
Flocc:Rūncræft	Catégorie:Rune
Flocc:Roteland	Catégorie:Rutland
Flocc:Sancte Elene Īeg, Upstigeīeg and Tristan da Cunha	Catégorie:Sainte-Hélène, Ascension et Tristan da Cunha
Flocc:Hjaltland	Catégorie:Shetland
Flocc:Scipu	Catégorie:Bateau
Flocc:Scrobbesbyrigscīr	Catégorie:Shropshire
Flocc:Byrig on Marianlande	Catégorie:Localité du Maryland
Flocc:Byrig on Pennsyluanie	Catégorie:Localité de Pennsylvanie
Flocc:Byrig on Wyominge	Catégorie:Localité du Wyoming
Flocc:Byrig on Gleawcesterscīre	Catégorie:Ville du Gloucestershire
Flocc:Napoleon I Francena Casere	Catégorie:Napoléon Bonaparte
Flocc:NHL	Catégorie:Ligue nationale de hockey
Flocc:Byrig on Nīwum Hāmtūnscīre	Catégorie:Ville du New Hampshire
Flocc:Byrig on Dūnholmscīre	Catégorie:Ville du Durham
Flocc:Byrig on Dēorabyscīre	Catégorie:Ville du Derbyshire
Flocc:Byrig on Defenum	Catégorie:Ville du Devon
Flocc:Byrig on Lonceasterscīre	Catégorie:Ville du Lancashire
Flocc:Americanisc fōtball	Catégorie:Football américain
Flocc:Stæffordscīr	Catégorie:Staffordshire
Flocc:Bermuda	Catégorie:Bermudes
Flocc:Bearrucscīr	Catégorie:Berkshire
Flocc:Byrig on Bearrucscīre	Catégorie:Ville du Berkshire
Flocc:Norþgermanisca sprǣca	Catégorie:Langue scandinave
Flocc:São Paulo	Catégorie:São Paulo
Flocc:Ucrægnisc sprǣc	Catégorie:Langue ukrainienne
Flocc:Westgermanisca sprǣca	Catégorie:Langue germanique occidentale
Flocc:Byrig on Sūþrigum	Catégorie:Ville du Surrey
Flocc:Byrig on Grantabrycgscīre	Catégorie:Ville du Cambridgeshire
Flocc:Byrig on Cornweallum	Catégorie:Ville des Cornouailles
Flocc:Byrig on Cent	Catégorie:Ville du Kent
Flocc:Byrig on Oxnafordscīre	Catégorie:Ville de l'Oxfordshire
Flocc:Byrig on Westmidlandscīre	Catégorie:Ville des Midlands de l'Ouest (comté)
Flocc:Dȳfung	Catégorie:Plongée
Flocc:Byrig on Scrobbesbyrigscīre	Catégorie:Ville du Shropshire
Flocc:Byrig on Stæffordscīre	Catégorie:Ville du Staffordshire
Flocc:Tūnas on Ceasterscīre	Catégorie:Village du Cheshire
Flocc:Byrig on Wigreceastrescīre	Catégorie:Ville du Worcestershire
Flocc:Byrig on Wæringscīre	Catégorie:Ville du Warwickshire
Flocc:Wichlawscīr	Catégorie:Comté de Wicklow
Flocc:Byrig on Wiltūnscīre	Catégorie:Ville du Wiltshire
Flocc:Nīwre Gecȳþnesse bōc	Catégorie:Livre du Nouveau Testament
Flocc:Antrimscīr	Catégorie:Comté d'Antrim (Irlande du Nord)
Flocc:Mageoscīr	Catégorie:Comté de Mayo
Flocc:Celtisc sprǣc	Catégorie:Langue celtique
Flocc:Coritiba Foot Ball Club	Catégorie:Coritiba Foot Ball Club
Flocc:Bryttisce Scīre	Catégorie:Comté au Royaume-Uni
Flocc:Landscipas Denemearce	Catégorie:Péninsule du Danemark
Flocc:Wendelsǣs īega	Catégorie:Île de la mer Méditerranée
Flocc:Orcanege	Catégorie:Orcades
Flocc:Byrig on Ēastseaxum	Catégorie:Ville du Sussex de l'Est
Flocc:Byrig on Russum	Catégorie:Localité de Russie
Flocc:Tūnas on Mageoscīre	Catégorie:Ville du Comté de Mayo
Flocc:Gyldfōtþōðres styccelicu gewritu	Catégorie:Wikipédia:ébauche football
Flocc:Byrig	Catégorie:Ville
Flocc:Brūcend fo-3	Catégorie:Utilisateur fo-3
Bárbara Paz	Bárbara Paz
Flocc:Personal life	Catégorie:Vie quotidienne
Flocc:Brūcend ang-0	Catégorie:Utilisateur ang-0
Flocc:Byrig on Idahon	Catégorie:Localité de l'Idaho
Flocc:Byrig on Mississippi	Catégorie:Localité du Mississippi
Flocc:Byrig on Westvirginie	Catégorie:Localité de Virginie-Occidentale
Flocc:Byrig on Nīwum Eoforwīce	Catégorie:City de l'État de New York
Flocc:Byrig on Brettum	Catégorie:Cité du Royaume-Uni
Bysen:Coord/display/title	Modèle:Coord/display/title
Flocc:Brūcend en-1	Catégorie:Utilisateur en-1
Flocc:Geboren in 1946	Catégorie:Naissance en 1946
Flocc:Brūcend de-1	Catégorie:Utilisateur de-1
Flocc:Geboren in 1920	Catégorie:Naissance en 1920
Flocc:Germanisc mægþ	Catégorie:Peuple germanique
Flocc:Īrisce Scīre	Catégorie:Comté d'Irlande
Flocc:Skrælingcynn	Catégorie:Amérindien
Flocc:Byrig on Turcum	Catégorie:Localité de Turquie
Flocc:Byrig on Cumbralande	Catégorie:Ville de Cumbria
Flocc:Byrig on Heortfordscīre	Catégorie:Ville du Hertfordshire
Hunna Rīce	Empire hunnique
Bysen:Bo	Modèle:Tibétain
Bysen:Mennisc bodiglārlicu ansīen	Modèle:Palette Corps humain
Wikipǣdia:Gecorene gemynddagas/Sēremōnaþ	Wikipédia:Éphéméride/juin
Wikipǣdia:Gecorene gemynddagas/Æfterra Gēola	Wikipédia:Éphéméride/janvier
Wikipǣdia:Gecorene gemynddagas/Hrēþmōnaþ	Wikipédia:Éphéméride/mars
Wikipǣdia:Gecorene gemynddagas/Þrimilcemōnaþ	Wikipédia:Éphéméride/mai
Bysen:Start date	Modèle:Date début
Bysen:Brūcend fo-0	Modèle:Utilisateur fo-0
Wikipǣdia:Dealing with vandalism	Aide:Vandalisme
Bysen:FPO number	Modèle:Nombre de portails de qualité
Wikipǣdia:10 þing þe þu nāst ymbe Wicipǣdian	Wikipédia:10 choses à savoir sur Wikipédia
Bysen:Brūcend cy-0	Modèle:Utilisateur cy-0
Bysen:Brūcend ang-2	Modèle:Utilisateur ang-2
Bysen:Brūcend ang-1	Modèle:Utilisateur ang-1
Bysen:Brūcend ang-3	Modèle:Utilisateur ang-3
Bysen:Species	Modèle:Species
Bysen:Brūcend cy-4	Modèle:Utilisateur cy-4
Bysen:Subfamilia	Modèle:Subfamilia
Bysen:SGSSI	Modèle:Palette Géorgie du Sud-et-les Îles Sandwich du Sud
Bleohcrāwe	Geai
Bysen:Brūcend fo-4	Modèle:Utilisateur fo-4
Bysen:Lang-kw	Modèle:Lang-kw
Bysen:Brūcend pt-5	Modèle:Utilisateur pt-5
Bysen:Brūcend la-5	Modèle:Utilisateur la-5
Bysen:Superfamilia	Modèle:Superfamilia
Bysen:Phylum	Modèle:Phylum
Bysen:Classis	Modèle:Classis
Bysen:Genus	Modèle:Genus
Swǣfe	Souabe
Wikipǣdia:Protection log	Wikipédia:Log de protection
Wikipǣdia:Block log	Wikipédia:Log de blocage
Wikipǣdia:Deletion log	Wikipédia:Historique des effacements
Hindberge	Framboisier
Bysen:End	Modèle:Fin
Peru (ofet)	Poire
Bysen:Syndrigebocstafas	Modèle:Unicode
Bysen:Imdb	Modèle:Imdb
Bysen:Country flagairforce	Modèle:Armée de l'air/callback
Lorde	Lorde
Georgius Grantanbrycge Æþeling	George de Cambridge
Bysen:Brūcend wunaþ on Nīwum Sǣlande	Modèle:Utilisateur habite Nouvelle-Zélande
Bysen:Familia	Modèle:Familia
Module:Yesno	Module:Yesno
Yun Hyon-seok	Yun Hyon-seok
Module:Arguments	Module:Arguments
Syndrig:RecentChanges	Spécial:Modifications récentes
Flocc:Byrig on Langbeardum	Catégorie:Commune de la région Lombardie
Flocc:Gestorfen in 1975	Catégorie:Décès en 1975
Gōs	Oie
