ܐܦܪܝܩܐ	Afrique
ܝܦܢ	Japon
ܐܡܪܝܩܐ ܬܝܡܢܝܬܐ	Amérique du Sud
ܢܘܪܒܝܓ	Norvège
ܩܘܛܢܝܘܬܐ ܕܐܝܪܠܢܕ	Irlande (pays)
ܡܓܪ	Hongrie
ܐܣܦܢܝܐ	Espagne
ܐܘܚܕܢܐ ܡܚܝܕܐ	États-Unis
ܒܠܓܝܩܐ	Belgique
ܠܘܟܣܡܒܘܪܓ	Luxembourg (pays)
ܬܒܝܠ	Univers
ܐܪܥܐ	Terre
ܡܘܬܐ	Mort
ܒܪ ܐܢܫܐ	Homo sapiens
ܓܘܪܓ ܘܐܫܝܢܓܛܘܢ	George Washington
ܦܝܢܠܢܕ	Finlande
ܣܘܝܕ	Suède
ܕܐܢܡܐܪܩ	Danemark
ܦܘܠܢܕ	Pologne
ܠܬܘܢܝܐ	Lituanie
ܐܝܛܠܝܐ	Italie
ܣܘܝܣܪܐ	Suisse
ܢܡܣܐ	Autriche
ܝܘܢ	Grèce
ܛܘܪܩܝܐ	Turquie
ܦܘܪܛܘܓܠ	Portugal
ܐܘܪܘܦܐ (ܝܒܫܬܐ)	Europe
ܐܣܝܐ (ܝܒܫܬܐ)	Asie
ܐܡܪܝܩܐ ܓܪܒܝܝܬܐ	Amérique du Nord
ܐܢܛܐܪܩܛܝܩܐ	Antarctique
ܘܝܩܝܦܕܝܐ	Wikipédia
ܗܘܠܢܕܐ	Pays-Bas
ܢܝܘ ܝܘܪܩ (ܡܕܝܢܬܐ)	New York
ܘܐܫܢܓܛܘܢ (ܐܪܫܟܝܬܐ)	Washington (district de Columbia)
ܒܪܠܝܢ	Berlin
ܚܫܘܒܐ (ܡܐܟܢܐ)	Ordinateur
ܒܪܢ	Berne
ܬܣܝܪܝܟ	Zurich
ܐܢܛܪܢܛ	Internet
ܒܪܐܩ ܐܘܒܐܡܐ	Barack Obama
ܠܘܢܕܘܢ	Londres
ܐܠܟܣܢܕܪܝܐ	Alexandrie
ܚܙܘܪܐ	Pomme
ܦܐܪܝܣ	Paris
ܡܟܣܝܩܘ	Mexique
ܐܘܩܝܢܘܣ ܐܛܠܢܛܝܐ	Océan Atlantique
ܐܘܩܝܢܘܣ ܫܝܢܝܐ	Océan Pacifique
ܒܘܣܛܘܢ	Boston
ܬܪܝܢܒܫܒܐ	Lundi
ܟܢܘܢ ܒ	Janvier
ܫܒܛ	Février
ܐܕܪ	Mars (mois)
ܟܘܫ	Éthiopie
ܢܝܣܢ	Avril
ܐܝܪ	Mai
ܚܙܝܪܢ	Juin
ܬܡܘܙ	Juillet
ܐܒ	Août
ܐܝܠܘܠ	Septembre
ܬܫܪܝܢ ܐ	Octobre
ܬܫܪܝܢ ܒ	Novembre
ܟܢܘܢ ܐ	Décembre
ܬܠܬܒܫܒܐ	Mardi
ܐܪܒܥܒܫܒܐ	Mercredi
ܚܡܫܒܫܒܐ	Jeudi
ܥܪܘܒܬܐ	Vendredi
ܫܒܬܐ (ܙܒܢܐ)	Samedi
ܚܕܒܫܒܐ	Dimanche
ܐܪܝܐ	Lion
ܦܪܢܣܐ	France
ܟܠܒܐ	Chien
ܡܠܟܘܬܐ ܡܚܝܕܬܐ	Royaume-Uni
ܩܛܐ	Chat
ܩܘܛܢܝܘܬܐ ܥܡܡܝܬܐ ܕܨܝܢ	Chine
ܠܫܢܐ ܦܪܢܣܝܐ	Français
ܒܪܐܙܝܠ	Brésil
ܪܘܣܝܐ	Russie
ܝܡܐ	Mer
ܝܡܐ ܐܘܟܡܐ	Mer Noire
Π	Pi (lettre grecque)
ܐܠܒܐܡܐ	Alabama
ܣܐܘ ܦܐܘܠܘ	São Paulo
ܩܝܒܩ (ܗܘܦܪܟܝܐ)	Québec
ܓܪܡܢ	Allemagne
ܒܠܐܪܘܣ	Biélorussie
ܠܫܢܐ ܓܪܡܢܝܐ	Allemand
ܐܠܗܐ	Dieu
ܐܣܛܘܢܝܐ	Estonie
ܛܝܣܬܐ	Avion
ܩܪܒܐ	Guerre
1 (ܡܢܝܢܐ)	1 (nombre)
2 (ܡܢܝܢܐ)	2 (nombre)
3 (ܡܢܝܢܐ)	3 (nombre)
4 (ܡܢܝܢܐ)	4 (nombre)
5 (ܡܢܝܢܐ)	5 (nombre)
ܠܐܛܒܝܐ	Lettonie
ܐܘܩܪܐܝܢܐ	Ukraine
ܬܫܝܟ	République tchèque
ܣܠܘܒܩܝܐ	Slovaquie
ܣܠܘܒܢܝܐ	Slovénie
ܡܘܠܕܘܒܐ	Moldavie
ܪܘܡܢܝܐ	Roumanie
ܒܘܠܓܐܪܝܐ	Bulgarie
ܪܗܘܡܐ (ܡܕܝܢܬܐ)	Rome
ܩܘܛܢܝܘܬܐ ܕܡܩܕܘܢܝܐ	Macédoine (pays)
ܐܠܒܢܝܐ	Albanie
ܩܪܘܐܛܝܐ	Croatie
ܒܘܣܢܐ ܘܗܪܬܣܓܘܒܝܢܐ	Bosnie-Herzégovine
ܐܙܪܒܝܓܐܢ	Azerbaïdjan
ܐܢܕܘܪܐ	Andorre
ܩܘܦܪܘܣ	Chypre (pays)
ܓܘܪܓܝܐ (ܐܬܪܐ)	Géorgie (pays)
ܩܙܩܣܛܐܢ	Kazakhstan
ܡܝܠܛܐ	Malte
ܡܘܢܐܩܘ	Monaco
ܛܘܪܐ ܐܘܟܡܐ	Monténégro
ܡܕܝܢܬܐ ܕܘܛܝܩܢ	Vatican
ܣܢ ܡܪܝܢܘ	Saint-Marin
ܒܪܘܟܣܠ	Région de Bruxelles-Capitale
ܠܘܕܒܝܓ ܒܐܢ ܒܝܛܗܘܒܢ	Ludwig van Beethoven
ܠܫܢܐ ܛܘܪܩܝܐ	Turc
ܓܙܐܐܪ	Algérie
ܐܘܙܒܩܣܛܐܢ	Ouzbékistan
ܘܐܪܣܘ	Varsovie
ܚܡܪܐ (ܫܬܝܐ)	Vin
ܡܝܐ	Eau
ܦܪܣ ܚܙܘܐ	Télévision
ܬܫܝܠܝ	Chili
ܐܠ ܓܪܝܩܘ	El Greco
ܝܫܘܥ	Jésus-Christ
ܠܫܢܐ (ܡܡܠܠܐ)	Langage
ܫܘܠܛܢ ܛܪܘܢܘܬܐ	Dictature
ܡܡܠܠܘܬ ܟܘܟܒܐ	Astronomie
ܡܪܝܡ (ܐܡܗ ܕܝܫܘܥ)	Marie (mère de Jésus)
ܠܝܟܛܢܫܛܝܢ	Liechtenstein
ܐܕܘܠܦ ܗܝܛܠܪ	Adolf Hitler
ܠܝܢܘܟܣ	Linux
ܠܫܢܐ ܠܐܛܝܢܝܐ	Latin
ܒܚܪܝܢ	Bahreïn
ܐܪܡܢܝܐ	Arménie
ܣܪܒܝܐ	Serbie
ܣܗܪܐ	Lune
ܐܝܣܛܢܒܘܠ (ܡܕܝܢܬܐ)	Istanbul
ܐܘܣܛܪܠܝܐ (ܐܬܪܐ)	Australie
ܦܝܣܝܟ	Physique
ܩܘܪܐܢ	Coran
ܐܣܠܐܡ	Islam
ܟܡܬܪܐ	Pyrus
ܠܟ ܒܐܘܢܣܐ	Lech Wałęsa
ܫܠܡܐ (ܫܝܢܐ)	Paix
ܚܘܝܕܐ ܐܘܪܘܦܝܐ	Union européenne
ܐܢܬܬܐ	Femme
ܛܝܙܐ	Anus
ܫܚܬܐ (ܝܘܠܦܢ ܨܪܘܝܘܬܐ)	Aisselle
ܗܒܒܐ	Fleur
ܝܘܠܦܢ ܨܪܘܝܘܬܐ	Anatomie
ܡܕܝܢܬܐ	Ville
ܢܐܦܠܝܘܢ ܒܘܢܐܦܪܛ	Napoléon Ier
ܟܘܟܒܐ	Étoile
ܫܡܫܐ	Soleil
ܩܪܝܬܐ	Village
ܝܡܐ ܕܡܕܢܚܐ	Mer Baltique
ܫܢܐ	Dent
ܘܝܩܝܡܝܕܝܐ ܩܘܡܡܘܢܣ	Wikimedia Commons
ܟܬܒܐ (ܣܦܪܐ)	Livre (document)
ܝܘܡܐ	Jour
ܠܠܝܐ	Nuit
ܫܢܬܐ (ܙܒܢܐ)	Année (calendrier)
ܕܪܐ	Siècle
ܐܘܣܠܘ	Oslo
ܠܫܒܘܢܐ	Lisbonne
ܦܠܝܛܐ	Planète
ܙܡܪܘܬܐ	Musique
ܡܘܣܩܒܐ	Moscou
ܠܫܢܐ ܐܝܛܠܝܐ	Italien
ܬܫܐܕ	Tchad
ܬܝܡܢܐ	Nord
ܢܝܘ ܙܝܠܢܕ	Nouvelle-Zélande
ܓܪܒܝܐ	Sud
ܗܢܕܘ	Inde
ܦܪܙܠܐ	Fer
ܡܥܪܒܐ	Ouest
ܡܕܢܚܐ	Est
ܒܢܙܘܝܠܐ	Venezuela
ܛܠܦܣܢܐ	Échecs
ܡܝܢ	Maine (État)
ܣܘܣܝܐ	Cheval
ܐܡܣܛܪܕܐܡ	Amsterdam
ܙܝܢܐ	Arme
ܚܝܘܬܐ	Animal
ܩܘܠܘܡܒܝܐ	Colombie
ܢܝܘ ܗܐܡܦܫܪ	New Hampshire
ܠܝܘܢܪܕܘ ܕܗ ܒܢܬܫܝ	Léonard de Vinci
ܡܐܣܐܬܫܘܣܬܣ	Massachusetts
ܐܘܛܪܝܟܛ (ܗܘܦܪܟܝܐ)	Utrecht (province)
ܟܘܢܝܬܝܟܬ	Connecticut
ܐܝܪܐܢ	Iran
ܥܝܪܐܩ	Irak
ܐܠܐܣܟܐ	Alaska
ܐܝܣܪܐܝܠ	Israël
ܐܘܛܪܝܟܛ (ܡܕܝܢܬܐ)	Utrecht
ܝܡܢ	Yémen
ܠܫܢܐ ܦܘܠܢܕܝܐ	Polonais
ܝܘܪܕܢܢ	Jordanie
ܩܝܪܓܝܙܣܛܐܢ	Kirghizistan
ܐܪܝܙܘܢܐ	Arizona
ܟܘܘܝܬ (ܐܬܪܐ)	Koweït
ܠܒܢܢ	Liban
ܐܘܪܝܓܘܢ	Oregon
ܐܡܪܝܩܐ	Amérique
ܝܘܬܐ	Utah
ܫܠܡܐ (ܦܬܓܡܐ)	Ciao
ܥܘܡܐܢ	Oman
ܦܐܩܣܛܐܢ	Pakistan
ܩܛܪ	Qatar
ܣܥܘܕܝܐ	Arabie saoudite
ܝܘܣܦ ܣܛܐܠܝܢ	Joseph Staline
ܣܘܪܝܐ	Syrie
ܛܐܓܝܩܣܛܐܢ	Tadjikistan
ܦܪܣ ܩܠܐ	Radiodiffusion
ܛܘܪܩܡܢܣܛܐܢ	Turkménistan
ܐܡܝܪܘܬܐ ܥܪܒܝܬܐ ܡܚܝܕܬܐ	Émirats arabes unis
ܐܦܓܐܢܣܛܐܢ	Afghanistan
ܕܗܒܐ	Or
ܡܠܝ	Mali
ܦܝܠܝܦܝܢܝܐ	Philippines
ܩܘܛܢܝܘܬܐ ܕܐܦܪܝܩܐ ܡܨܥܝܬܐ	République centrafricaine
ܐܝܣܚܩ ܢܝܘܛܢ	Isaac Newton
ܫܥܘܬܐ (ܓܘܢܐ)	Jaune
ܬܘܢܣ (ܐܬܪܐ)	Tunisie
ܬܝܡܢܐ ܕܣܘܕܐܢ	Soudan du Sud
ܩܘܛܢܝܘܬܐ ܕܩܘܢܓܘ	République du Congo
ܩܘܛܢܝܘܬܐ ܕܩܘܢܓܘ ܕܝܡܘܩܪܛܝܬܐ	République démocratique du Congo
ܦܐܦܐ ܝܘܚܢܢ ܦܘܠܘܣ ܬܪܝܢܐ	Jean-Paul II
ܛܒܝܠܝܣܝ	Tbilissi
ܩܐܡܪܘܢ	Cameroun
ܠܘܒܐ	Libye
ܡܘܪܝܛܢܝܐ	Mauritanie
ܡܓܪܒ	Maroc
ܢܝܓܪ	Niger
ܣܘܕܐܢ	Soudan
ܩܫܬܐ ܕܡܪܢ	Arc-en-ciel
ܗܐܡܒܘܪܓ	Hambourg
ܝܡܬܐ ܕܐܘܢܛܪܝܘ	Lac Ontario
ܝܡܬܐ ܕܣܘܦܝܪܝܘܪ	Lac Supérieur
ܓܐܘܓܪܦܝܐ	Géographie
ܠܒܐ	Cœur
ܡܘܚܐ	Cerveau
ܓܠܕܐ	Peau
ܓܘܢܐ	Couleur
ܦܪܐܓ	Prague
ܙܪܩܐ	Bleu
ܟܣܦܐ (ܣܐܡܐ)	Argent
ܡܫܝܓܢ	Michigan
ܝܡܬܐ ܕܡܝܫܝܓܢ	Lac Michigan
ܐܠܝܢܘܝ	Illinois
ܢܘܪܬ ܕܐܟܘܬܐ	Dakota du Nord
ܣܐܘܬ ܕܐܟܘܬܐ	Dakota du Sud
ܡܘܢܬܐܢܐ	Montana
ܘܐܝܘܡܝܢܓ	Wyoming
ܐܘܪܫܠܡ	Jérusalem
ܐܝܕܐܗܘ	Idaho
ܢܝܒܐܕܐ	Nevada
ܐܘܩܝܢܘܣ ܗܢܕܘܝܐ	Océan Indien
ܟܘܠܘܪܐܕܘ	Colorado
ܫܝܩܓܘ	Chicago
ܣܬܘܐ	Hiver
ܬܕܐܐ	Printemps
ܩܝܛܐ	Été
ܬܫܪܝܬܐ	Automne
ܨܕܐܡ ܚܘܣܝܢ	Saddam Hussein
ܠܫܢܐ ܐܣܦܢܝܐ	Espagnol
ܓܘܓܝ	Araneae
ܐܒܐ (ܦܐܪܐ)	Fruit (botanique)
ܩܘܦܐ	Singe
ܒܪܓܝܢܝܐ	Virginie (État)
ܝܡܬܐ ܕܝܘܪܘܢ	Lac Huron
ܢܝܘ ܝܘܪܩ (ܐܘܚܕܢܐ ܡܚܝܕܐ)	État de New York
ܪܘܕ ܐܝܠܐܢܕ	Rhode Island
ܪܚܫܐ	Insecte
ܡܐܪܝܠܐܢܕ	Maryland
ܕܝܠܐܘܝܪ	Delaware
ܐܘܗܐܝܘ	Ohio
ܦܢܣܝܠܒܐܢܝܐ	Pennsylvanie
ܐܝܛܙܢ	Uetersen
ܐܓܘܣܛܘܣ ܩܣܪ	Auguste
ܢܝܘ ܓܝܪܣܝ	New Jersey
ܐܢܕܝܐܢܐ	Indiana
ܪܕܝܬܐ	Automobile
ܓܘܪܓܝܐ (ܐܘܚܕܢܐ ܡܚܝܕܐ)	Géorgie (États-Unis)
ܣܩܠܝܐ	Sicile
ܣܢ (ܢܗܪܐ)	Seine
ܛܘܩܝܘ	Tokyo
ܦܪܕܝܢܢܕ ܡܓܝܠܢ	Fernand de Magellan
ܢܝܘ ܡܝܟܣܝܟܘ	Nouveau-Mexique
ܐܬܢܘܣ	Athènes
ܡܢܝܣܘܬܐ	Minnesota
ܒܓܕܐܕ (ܡܕܝܢܬܐ)	Bagdad
ܘܝܣܟܘܢܣܢ	Wisconsin
ܐܝܐܘܐ	Iowa
ܢܝܒܪܐܣܟܐ	Nebraska
ܟܐܢܣܐܣ	Kansas
ܡܝܙܘܪܝ	Missouri (État)
ܐܪܟܢܣܐܣ	Arkansas
ܠܫܢܐ ܕܐܘܪܕܘ	Ourdou
ܐܘܟܠܐܗܘܡܐ	Oklahoma
ܝܡܐ ܕܓܪܒܝܐ	Mer du Nord
ܒܝܝܢܐ	Vienne (Autriche)
ܩܘܦܢܗܐܓܢ	Copenhague
ܣܛܘܩܗܘܠܡ	Stockholm
ܗܠܣܢܩܝ	Helsinki
ܕܒܠܢ	Dublin
ܒܪܛܝܣܠܐܒܐ	Bratislava
ܟܬܒܐ ܩܕܝܫܐ	Bible
ܥܕܬܐ ܫܪܝܪܬܐ ܕܝܫܘܥ	Véritable Jésus Église
ܠܫܢܐ ܐܢܓܠܝܐ	Anglais
ܩܘܢܣܦܣܝܘܢ (ܬܫܝܠܝ)	Concepción (Chili)
ܐܘܢܛܐܪܝܘ	Ontario
ܡܐܢܝܛܘܒܐ	Manitoba
ܐܠܒܪܛܐ	Alberta
ܢܘܒܐ ܣܩܘܛܝܐ	Nouvelle-Écosse
ܩܘܢܣܩܘܒܘܠܐ	Końskowola
ܢܝܘ ܒܪܘܢܙܘܝܩ	Nouveau-Brunswick
ܩܘܠܘܡܒܝܐ ܒܪܝܛܝܬܐ	Colombie-Britannique
ܓܙܪܬܐ ܕܐܡܝܪܐ ܐܕܘܐܪܕ	Île-du-Prince-Édouard
ܣܐܣܩܐܬܫܘܐܢ	Saskatchewan
2012	2012
2011	2011
2010	2010
2009	2009
ܢܝܘܦܐܘܢܕܠܢܕ ܘܠܐܒܪܐܕܘܪ	Terre-Neuve-et-Labrador
2008	2008
ܐܘܚܕܢܐ ܓܪܒܝܝܐ-ܡܥܪܒܝܐ	Territoires du Nord-Ouest
ܝܘܩܘܢ	Yukon
2005	2005
2006	2006
ܢܘܢܐܒܘܛ	Nunavut
2007	2007
ܡܐܟܘܠܬܐ	Nourriture
ܚܘܝܐ	Serpentes
ܩܘܪܘܦ	Kurów
ܟܝܡܝܐ	Chimie
1968	1968
ܩܛܠܥܡܐ ܝܗܘܕܝܐ	Shoah
ܡܕܪܝܕ (ܡܕܝܢܬܐ)	Madrid
ܗܘܦܪܟܝܣ ܘܐܘܚܕܢܐ ܕܩܢܕܐ	Provinces et territoires du Canada
ܣܢܛܝܐܓܘ ܕܐ ܬܫܝܠܝ	Santiago
ܚܐܪܘܬܐ	Liberté
ܣܝܕܢܝ	Sydney
ܝܪܘܩܐ	Vert
ܡܠܒܘܪܢ	Melbourne
ܣܘܡܩܐ	Rouge
ܢܘܪܐ (ܕܠܩܐ)	Feu
ܢܝܠܘܣ	Nil
ܓܙܐܐܪ (ܡܕܝܢܬܐ)	Alger
ܬܘܢܣ (ܡܕܝܢܬܐ)	Tunis
ܛܗܪܐܢ	Téhéran
ܐܢܩܪܐ	Ankara
ܢܝܐܡܝ	Niamey
ܒܡܩܘ	Bamako
ܕܪܡܣܘܩ	Damas
ܥܡܐܢ	Amman
ܒܝܪܘܬ	Beyrouth
ܒܝܬ ܨܘܒܐ	Université
ܒܝܬܐ (ܒܢܝܢܐ)	Maison
ܐܘܣܛܪܠܝܐ (ܝܒܫܬܐ)	Continent australien
ܢܗܪܐ	Rivière
ܪܝܫܐ ܕܣܒܪܐ ܛܒܐ	Cap de Bonne-Espérance
ܫܘܚܡܠܐ	Investissement
ܩܘܪܝܛܝܒܐ	Curitiba
ܥܒܐ	Forêt
ܩܘܢܦܘܫܝܘܣ	Confucius
ܩܢܐ	Nid
ܐܘܪܘ	Euro
ܝܡܐ ܚܘܪܐ ܡܨܥܝܐ	Mer Méditerranée
ܓܘܪܓܝܐ	Georgia
ܡܫܝܚܝܘܬܐ	Christianisme
ܩܠܒܐ:ܐܘܝܐ	Modèle:Pour
ܪܘܙܐ	Riz
ܝܒܫܬܐ	Continent
ܛܝܪܐ	Oiseau
ܐܪܫܟܝܬܐ	Capitale
ܠܫܢܐ ܦܘܪܛܘܓܠܝܐ	Portugais
ܝܪܚܐ	Mois
ܡܘܨܛܦܐ ܟܡܐܠ ܐܛܐܛܘܪܩ	Mustafa Kemal Atatürk
ܐܠܡܐܙܢ	Almazán
ܠܫܢܐ ܝܦܢܝܐ	Japonais
ܦܐܬܐ ܪܝܫܝܬܐ	Wikipédia:Accueil principal
ܦܪܢܣܝܣܩܘ ܓܘܝܐ	Francisco de Goya
ܝܡܐ ܐܚܪܝܐ	Mer Caspienne
ܝܡܬܐ ܕܐܝܪܝ	Lac Érié
ܣܠܒܐܕܘܪ ܕܐܠܝ	Salvador Dalí
ܒܢܣܢܬ ܦܢ ܟܘܟ	Vincent van Gogh
ܦܪܝܕܐ ܩܐܠܘ	Frida Kahlo
ܗܢܪܝ ܡܐܛܝܣ	Henri Matisse
ܡܝܟܠܐܢܓܠܘ	Michel-Ange
ܦܒܠܘ ܦܝܩܐܣܘ	Pablo Picasso
ܪܡܒܪܢܛ	Rembrandt
ܐܢܕܝ ܘܘܪܗܘܠ	Andy Warhol
ܢܝܢܘܐ (ܡܕܝܢܬܐ)	Ninive
ܒܒܠ	Babylone
ܐܝܪܝܚܘ	Jéricho
ܩܛܠܘܢܝܐ	Catalogne
ܡܕܪܝܕ (ܗܘܦܪܟܝܐ)	Communauté de Madrid
ܒܝܬ ܠܚܡ	Bethléem
ܣܕܪܐ:Candidates for speedy deletion	Catégorie:Wikipédia:Suppression immédiate demandée
ܪܫܡܠܘܬܐ	Capitalisme
ܐܘܡܬܐ	Nation
ܩܪܬܐܓܘ	Carthage
ܣܕܪܐ:ܐܣܛܪܘܢܘܡܝܐ	Catégorie:Astronomie
ܨܚܪܐܐ	Sahara
ܫܐܕܐ	Diable
ܒܝܬ ܟܬܒܐ	Bibliothèque
ܫܘܠܛܢܘܬܐ (ܫܘܬܐܣܐ)	Gouvernement
ܬܫܝܢ ܫܝ ܗܘܐܢܓ	Qin Shi Huang
ܡܕܢܚܐ ܡܨܥܝܬܐ	Moyen-Orient
ܡܠܟܘܬܐ	Monarchie
ܩܘܛܢܝܘܬܐ	République
ܐܬܪܐ	État
ܓܒܐ	Parti politique
ܝܗܘܕܝܐ	Juifs
ܝܡܡܬܐ ܪܘܪܒܬܐ	Grands Lacs (Amérique du Nord)
ܐܘܩܝܢܘܣ ܬܝܡܢܝܐ	Océan Austral
ܐܕܢܐ (ܝܘܠܦܢ ܨܪܘܝܘܬܐ)	Oreille
ܢܚܝܪܐ	Nez
ܥܝܢܐ (ܝܘܠܦܢ ܨܪܘܝܘܬܐ)	Œil
ܥܘܩܒܪܬܐ	Muscle
ܙܡܝܪܬܐ	Chanson
ܓܡܠܐ	Camelus
ܫܘܫܡܢܐ	Fourmi
ܕܒܫܬܐ	Abeille
ܠܫܢܐ ܗܘܠܢܕܝܐ	Néerlandais
ܐܡܐ (ܒܝܬܝܘܬܐ)	Mère
ܐܒܐ (ܒܝܬܝܘܬܐ)	Père
1847	1847
ܨܦܪܐ (ܙܒܢܐ)	Matin
ܪܡܫܐ	Soir
ܩܛܝܢܬܐ	Minute (temps)
ܠܫܢܐ ܪܘܣܝܐ	Russe
ܩܢܘܢܐ	Droit
ܠܫܢܐ ܨܝܢܝܐ	Langues chinoises
ܕܡܐ	Sang
ܬܓܪܘܡܬܐ	Squelette
ܪܐܬܐ	Poumon
ܠܫܢܐ ܪܘܡܢܝܐ	Roumain
ܡܛܪܐ	Pluie
ܢܠܣܘܢ ܡܐܢܕܝܠܐ	Nelson Mandela
ܐܒܢܐ	Roche
ܥܢܢܐ	Nuage
ܩܢܘܢܐ ܕܠܥܙܐ	Grammaire
ܠܫܢܐ ܓܘܪܓܝܐ	Géorgien
ܝܘܠܦܢ ܡܡܫܚܘܬܐ	Sciences économiques
ܙܘܙܐ	Devise (monnaie)
ܡܕܐܬܐ	Impôt
ܐܠܦܒܝܬ ܥܪܒܝܐ	Alphabet arabe
ܐܠܦܒܝܬ ܝܘܢܝܐ	Alphabet grec
ܐܠܦܒܝܬ ܠܐܛܝܢܝܐ	Alphabet latin
ܣܕܪܐ:ܦܪܢܣܐ	Catégorie:France
ܟܢܫܐ	Société (sciences sociales)
ܓܒܪܐ	Homme
ܙܘܘܓܐ	Mariage
ܙܕܩܐ ܕܒܪܢܫܐ	Droits de l'homme
ܩܪܒܐ ܓܘܝܐ	Guerre civile
ܓܪܡܐ ܕܣܢܘܢܝܬܐ	Sternum
ܬܪܝܢܐ	Jus de fruits
ܚܠܒܐ (ܕܝܘܒܐ)	Lait
ܛܘܪܐ	Montagne
ܡܕܒܪܐ	Désert
ܠܫܢܐ ܐܠܒܢܝܐ	Albanais
ܠܫܢܐ ܐܪܡܢܝܐ	Arménien
ܝܘܗܐܢ ܓܘܛܢܒܪܓ	Johannes Gutenberg
ܠܫܢܐ ܣܘܝܕܝܐ	Suédois
ܢܝܩܘܠܐ ܛܣܠܐ	Nikola Tesla
ܡܘܫܐ	Moïse
ܬܕܐ	Sein
ܢܘܗܪܐ (ܚܙܝܬܐ)	Lumière
ܠܫܢܐ ܝܘܢܝܐ	Grec
ܠܫܢܐ ܦܪܣܝܐ	Persan
ܬܘܕܝܬܐ	Religion
ܐܒܪܗܡ	Abraham
ܣܦܪܐ ܕܒܪܝܬܐ	Livre de la Genèse
ܠܫܢܐ ܩܢܛܘܢܝܐ	Cantonais standard
ܠܫܢܐ ܡܢܕܪܝܢܝܐ	Mandarin (langue)
ܦܘܠܘܣ ܫܠܝܚܐ	Paul de Tarse
ܙܝܓܡܘܢܕ ܦܪܘܝܕ	Sigmund Freud
ܙܠܛܐ	Salade (mets)
ܝܗܘܕܝܘܬܐ	Judaïsme
ܠܫܢܐ ܥܒܪܝܐ	Hébreu
ܟܒܕܐ	Foie
ܛܚܠܐ	Rate
ܟܘܠܝܬܐ	Rein
ܫܠܦܘܚܬܐ	Vessie
ܐܫܟܐ	Testicule
ܐܘܩܝܢܘܣ	Océan
ܒܘܕܗܐ	Siddhartha Gautama
ܡܘܚܡܕ	Mahomet
ܟܪܣܐ	Abdomen
ܚܒܠܐ ܟܘܒܝܐ	Moelle épinière
ܘܪܝܕܐ	Veine
ܡܪܒܥܐ	Utérus
ܠܫܢܐ (ܗܕܡܐ)	Langue (anatomie humaine)
ܓܝܕܐ	Nerf
ܨܘܪܐ (ܝܘܠܦܢ ܨܪܘܝܘܬܐ)	Cou
ܦܘܡܐ	Bouche
ܓܓܪܬܐ	Larynx
ܡܥܝܐ	Intestin
ܫܪܝܬܐ	Articulation (anatomie)
ܚܕܝܐ	Torse
ܬܝܪܬܐ	Glande
ܚܠܒܐ (ܝܘܠܦܢ ܨܪܘܝܘܬܐ)	Diaphragme (organe)
ܫܪܝܢܐ	Artère
A	A (lettre)
B	B (lettre)
ܢܘܛܦܬܐ	Sperme
G	G (lettre)
U	U (lettre)
Z	Z (lettre)
F	F (lettre)
J	J (lettre)
ܐܠܦܒܝܬ	Alphabet
T	T (lettre)
C	C (lettre)
R	R (lettre)
D	D (lettre)
Α	Alpha
Ω	Oméga
I	I (lettre)
Μ	Mu (lettre grecque)
E	E (lettre)
H	H (lettre)
ܗܐܪܠܡ (ܗܘܠܢܕܐ)	Haarlem
K	K (lettre)
L	L (lettre)
M	M (lettre)
N	N (lettre)
O	O (lettre)
Q	Q (lettre)
S	S (lettre)
V	V (lettre)
W	W (lettre)
X	X (lettre)
Y	Y (lettre)
ܐܢܫܟܕܐ	Enschede
ܗܢܓܠܘ	Hengelo (Overijssel)
Φ	Phi
ܝܘܢܐ	Columbidae
ܐܝܠܢܐ	Arbre
Λ	Lambda
ܓܒܬܐ	Fromage
ܥܢܒܬܐ	Raisin
ܕܒܫܐ	Miel
ܒܣܪܐ	Viande
ܫܟܪ	Sucre
ܣܦܪܙܒܢܐ	Journal
ܙܥܘܩܐ	Téléphone
ܡܪܕܘܬܐ	Culture
ܡܥܝܐ ܥܒܝܐ	Gros intestin
ܡܥܝܐ ܩܛܝܢܐ	Intestin grêle
ܣܘܪܓܕܐ ܝܘܠܝܝܐ	Calendrier julien
ܐܣܝܘܬܐ	Médecine
ܡܠܚܐ (ܐܨܪܐ)	Sel alimentaire
ܣܕܪܐ:ܒܪܐܙܝܠ	Catégorie:Brésil
ܙܘܝܬܐ (ܡܚܪܘܬܐ)	Angle
ܬܘܩܦܐ	Énergie
ܣܦܝܢܬܐ	Navire
ܩܠܐ (ܨܘܬܐ)	Son (physique)
ܙܓܘܓܝܬܐ	Verre
ܫܛܝܚܘܬܐ	Aire (géométrie)
ܡܢܝܢܐ	Nombre
ܪܦܦܐ	Seconde (temps)
ܣܥܪܬܐ	Orge commune
ܘܘܗܐܢ	Wuhan
ܡܟܬܒܢܘܬܐ ܕܐܬܪܘܬܐ	Liste des pays du monde
ܒܝܬ ܢܗܪܝܢ	Mésopotamie
ܕܒܐ	Ursidae
ܬܠܗܝܐ	Cancer
ܡܠܟܐ	Roi
ܚܛܬܐ	Blé
ܣܘܪܓܕܐ	Calendrier
ܟܘܪܗܢܐ	Maladie
ܣܘܪܓܕܐ ܓܪܝܓܘܪܝܐ	Calendrier grégorien
ܟܦܣܐ	Menstruation
ܥܡܐ ܩܪܕܘܝܐ	Kurdes
ܓܫܪܐ	Pont
ܡܓܕܠܐ (ܒܢܝܢܐ)	Tour (édifice)
ܐܡܪܝܩܐ ܠܐܛܝܢܝܬܐ	Amérique latine
ܟܗܪܒܐ	Électricité
ܡܙܝܥܢܐ ܕܩܝܕܐ ܓܘܝܐ	Moteur à combustion interne
ܣܝܦܐ (ܙܝܢܐ)	Épée
ܫܡܥܘܢ ܩܢܢܝܐ	Simon le Zélote
ܩܪܩܦܬܐ	Crâne
ܓܘܡܠܐ!	Joomla!
ܐܦܫܬܐ	Raisin sec
ܠܫܢܐ ܕܗܣܝܐܢܓ	Xiang
ܠܫܢܐ ܥܪܒܝܐ	Arabe
ܠܫܢܐ ܐܦܪܝܩܐܢܝܐ	Afrikaans
Β	Bêta
Γ	Gamma
Δ	Delta
Ε	Epsilon
Ζ	Zêta
Η	Êta
Θ	Thêta
Ι	Iota
Κ	Kappa
Ν	Nu (lettre grecque)
Ξ	Xi
Ο	Omicron
Ρ	Rhô
Σ	Sigma
Τ	Tau
Υ	Upsilon
Χ	Chi
Ψ	Psi (lettre grecque)
ܐܬܐ	Drapeau
ܟܪܦܬܐ	Meuble
ܟܘܪܣܝܐ	Chaise
ܣܦܬܐ	Lèvre
ܦܣܡܐ	Moustache
ܥܩܠܐ	Pied (anatomie humaine)
1000000000 (ܡܢܝܢܐ)	Milliard (nombre)
ܓܪܡܐ ܕܨܕܥܐ	Os temporal
ܩܠܝܕܐ (ܓܪܡܐ)	Clavicule
ܟܬܦܐ	Épaule
ܦܟܐ ܬܚܬܝܐ	Mandibule (os)
ܥܠܡܐ (ܐܪܥܐ)	Monde (univers)
ܘܝܩܝܦܕܝܐ:ܬܪܥܐ ܕܟܢܫܐ	Wikipédia:Le Bistro
ܒܝܪܡܘܢܬ	Vermont
ܩܘܣܛܢܛܝܢܘܦܘܠܝܣ	Constantinople
ܒܝܬ ܟܪܝܗܐ	Hôpital
ܥܕܬܐ	Église (édifice)
ܕܝܬܝܩܝ ܚܕܬܐ	Nouveau Testament
9 (ܡܢܝܢܐ)	9 (nombre)
1002	1002
ܦܘܕܘܠܣܟ	Podolsk
ܦܐܦܐ	Pape
5	5
4	4
ܢܝܒܐ	Canine
3	3
2	2
ܒܝܬ ܥܬܩܐ ܕܠܘܒܪ	Musée du Louvre
ܓܒܐ ܕܚܐܪܘܬܐ ܕܦܘܐܪܛܘ ܪܝܩܘ	Parti indépendantiste portoricain
6	6
ܕܝܬܝܩܝ ܥܬܝܩܬܐ	Ancien Testament
ܥܐܕܐ ܕܒܝܬ ܝܠܕܐ	Noël
ܠܫܢܐ ܪܘܡܐܢܣܝܐ	Langues romanes
ܡܬܠܬܐ	Triangle
ܫܢܬܐ ܟܒܝܫܬܐ	Année bissextile
ܡܘܥܡܪ ܐܠܩܕܐܦܝ	Mouammar Kadhafi
ب	Bāʾ
ܥܐܕܐ ܕܩܝܡܬܐ	Pâques
ܢܝܘ ܝܘܪܩ	New York (homonymie)
ܢܦܛܐ	Pétrole
ܣܐܘܢܐ	Chaussure
ܒܝܬ ܥܘܪܦܢܐ	Banque
ܟܪܡܐ	Vignoble
ܐܝܪܠܢܕ (ܓܙܪܬܐ)	Irlande (île)
1	1
ܠܘ ܫܘܢ	Lu Xun (écrivain)
10	10
20	20
9	9
7	7
8	8
7 (ܡܢܝܢܐ)	7 (nombre)
8 (ܡܢܝܢܐ)	8 (nombre)
12	12
ܡܠܐܐ ܘܬܘܒܐ	Marée
ܫܒܘܥܐ	Semaine
ܓܠܝܕܐ	Glace
ܨܠܘܬܐ ܡܪܢܝܬܐ	Notre Père
ܝܡܬܐ	Lac
ܝܡܐ ܣܘܡܩܐ	Mer Rouge
13	13
ܩܛܘܬܐ (ܝܥܝܬܐ)	Concombre
ܓܙܪܬܐ	Île
ܚܘܪܐ	Blanc
ܐܘܟܡܐ	Noir
6 (ܡܢܝܢܐ)	6 (nombre)
ܠܫܢܐ ܪܘܫܡܝܐ	Langue officielle
11	11
15	15
14	14
17	17
ܣܦܪ ܡܠܐ	Dictionnaire
18	18
19	19
16	16
21	21
ܦܠܣܛܝܢ	Palestine
10 (ܡܢܝܢܐ)	10 (nombre)
ܡܣܘܪܩܐ (ܡܐܢܐ)	Peigne
ܠܝܠܐ ܕܘܢܤ	Lila Downs
ܝܡܐ ܕܡܠܚܐ	Mer Morte
ܫܘܚܠܦܐ ܕܫܢܬܐ	Saison
ܠܝܒܪܦܘܠ	Liverpool
ܩܘܦܬܐ (ܛܝܪܐ)	Strigiformes
ܫܥܬܐ	Heure
ܢܐܘܝ ܕܘܪ ܟܪܘܠܣܟܝ	Nowy Dwór Królewski
ܐܪܙܦܬܐ	Marteau (outil)
ܝܘܢܫܘܦܝܢ	Jönköping
ܥܘܠܐ ܚܝܐ	Fœtus
ܐܠܦܒܝܬ ܣܘܪܝܝܐ	Alphabet syriaque
ܐܠܦܒܝܬ ܐܪܡܝܐ	Alphabet araméen
ܐܣܝܐ ܡܥܪܒܝܬܐ	Asie de l'Ouest
ܙܡܪܐ	Chant
ܫܓܠܐ	Marelle
ܩܠܦܬܐ ܕܒܣܡܐ	Cannelle (écorce)
ܡܙܬܐ	Poil
ܠܫܢܐ ܐܪܡܝܐ	Araméen
ܨܦܪܐ (ܛܝܪܐ)	Passeridae
ܐܦܣܩܘܦܐ	Évêque
ܨܝܢ (ܐܪܥܐ)	Monde chinois
ܓܒܐ ܕܝܡܘܩܪܛܝܐ (ܐܘܚܕܢܐ ܡܚܝܕܐ)	Parti démocrate (États-Unis)
ܒܝܐܛܪܝܟܣ ܕܒܝܬ ܗܘܠܢܕܝܐ	Beatrix (reine des Pays-Bas)
ܐܒܪܝܠ ܠܐܒܝܢ	Avril Lavigne
ܪܝܫ ܩܘܛܢܝܘܬܐ	Président
ܐܚܐ (ܒܝܬܝܘܬܐ)	Fratrie
ܐܪܒܝܐ	Arabie
ܡܪܩܘܣ ܐܘܢܓܠܣܛܐ	Marc (évangéliste)
ܥܘܠܐ	Embryon
ܠܫܢܐ ܕܗܟܐ	Hakka (langue)
ܐܪܡܝܐ ܕܒܬܠܡܘܕ ܒܒܠܝܐ	Judéo-araméen babylonien
ܫܘܫܡܢܝܬܐ (ܝܥܝܬܐ)	Cardamome
ܠܫܢܐ ܕܓܐܢ	Gan (langue)
ܒܝܬ ܥܬܩܐ	Musée
ܐܠܦܒܝܬ ܥܒܪܝܐ	Alphabet hébreu
ܠܫܢܐ ܣܘܪܝܝܐ	Syriaque
ܒܪܩܐ	Foudre
ܐܝܕܐ	Main
ܫܡܥܘܢ ܟܐܦܐ	Pierre (apôtre)
ܬܠ ܐܒܝܒ	Tel Aviv-Jaffa
ܒܐܠܦܐܪܐܝܣܘ	Valparaiso
ܛܘܪܝܐ	Turoyo
ܠܫܢܐ ܫܝܡܝܐ	Langues sémitiques
ܚܘܣܢܝ ܡܘܒܐܪܟ	Hosni Moubarak
ܘܐܟܐܩܐ	État de Oaxaca
ܚܐܘܬܐ	Beurre
ܐܘܢܓܠܝܘܢ	Évangiles
ܠܫܢܐ ܕܘܘ	Wu (langue)
ܪܘܛܪܕܐܡ	Rotterdam
ܩܪܛܐ	Crète
ܐܘܪܚܐ	Route
ܩܘܪܨܐ ܚܠܝܨܐ	Disque compact
ܨܒܥܐ	Doigt
ܦܪܬ	Euphrate
ܩܝܘܛܘ	Kyoto
ܥܣܪܐ ܦܘܩܕܢܐ	Décalogue
ܒܪܩܩܐ ܦܪܣܝܐ	Golfe Persique
ܚܠܐ (ܕܚܝܚܐ)	Sable
ܘܪܕܐ	Rosier
ܓܙܪܬܐ ܝܒܫܢܝܬܐ	Péninsule
ܐܘܪܝܬܐ	Torah
ܟܘܘܝܬ (ܡܕܝܢܬܐ)	Koweït (ville)
ܡܚܙܝܬܐ	Miroir
ܥܡܐ ܥܪܒܝܐ	Arabes
ܟܘܬܐ	Fenêtre
ܠܫܢܐ ܝܘܢܝܐ ܥܬܝܩܐ	Grec ancien
ܠܫܢܐ ܐܟܕܝܐ	Akkadien
ܕܩܠܬ	Tigre (fleuve)
ܐܬܪܘܬܐ ܕܐܬܪܘܬܐ ܡܚܝܕܐ ܕܐܡܪܝܩܐ	États des États-Unis
ܡܥܡܘܕܝܬܐ	Baptême
ܩܘܢܓܘ	Congo
ܐܝܢܛܪܠܝܢܓܘܐ	Interlingua (IALA)
ܐܘܪܟܐ	Longueur
ܚܠܡܐ	Rêve
ܠܫܢܐ ܩܪܕܘܝܐ	Kurde
ܩܡܚܐ	Farine
ܕܢ ܗܐܟ	La Haye
ܠܫܢܐ ܦܘܢܝܩܝܐ	Phénicien
ܣܝܢܝ (ܓܙܪܬܐ ܝܒܫܢܝܬܐ)	Sinaï
ܟܪܘܙܘܬܐ ܕܝܘܚܢܢ	Évangile selon Jean
ܬܪܥܐ (ܒܒܐ)	Porte (architecture)
ܪܝܗܐܢܐ	Rihanna
ܛܦܪܐ	Ongle
ܐܦܐ	Visage
ܨܨܐ (ܨܢܥܬܐ)	Clou
ܙܝܬܐ	Olivier
ܬܠܝܬܝܘܬܐ	Trinité (christianisme)
ܓܠܠܐ	Onde
ܟܬܒܬܐ	Écriture
ܪܘܚܐ ܕܩܘܕܫܐ	Saint-Esprit
100 (ܡܢܝܢܐ)	100 (nombre)
ܒܘܪܟܐ	Genou
ܫܘܩܐ (ܬܐܓܪܘܬܐ)	Marché
ܠܫܢܐ ܥܪܒܝܐ ܝܗܘܕܝܐ	Judéo-arabe
ܒܠܛܝ	Bălți
1000000 (ܡܢܝܢܐ)	Million
ܛܐܒܐ	Actualité
ܐܫܬܐ (ܐܣܝܘܬܐ)	Fièvre
ܩܫܬܐ ܓܪܒܝܝܬܐ ܕܐܪܥܐ	Hémisphère nord
ܡܡܘܢܐ ܕܡܝܟܪܐ	Microéconomie
ܠܝܕܣ	Leeds
ܥܘܩܒܪܐ	Mus (genre)
ܦܘܪܬܩܠܐ	Orange (couleur)
ܒܪܩܩܐ	Baie (géographie)
ܒܝܬ ܩܒܘܪܐ	Cimetière
ܐܣܝܐ (ܫܕܬܐ)	Médecin
ܡܩܕܘܢܝܐ	Macedonia
ܦܢܛܝܩܘܣܛܝ	Pentecôte
ܫܓܕܬܐ	Amandier
ܟܪܘܙܘܬܐ ܕܠܘܩܐ	Évangile selon Luc
ܩܘܢܣܦܣܝܘܢ (ܗܘܦܪܟܝܐ)	Province de Concepción (Chili)
ܢܗܪܐ ܕܝܘܪܕܢܢ	Jourdain
ܣܦܪ ܝܡܐ	Plage
ܐܢܛܐܠܝܐ (ܗܘܦܪܟܝܐ)	Antalya (province)
ܦܪܟܣܝܣ ܕܫܠܝܚܐ	Actes des Apôtres
ܥܪܘܒܬܐ ܕܚܫܐ	Vendredi saint
ܚܒܘܫܝܐ	Prison
ܐܕܢܐ (ܗܘܦܪܟܝܐ)	Adana (province)
ܝܘܚܢܢ ܡܥܡܕܢܐ	Jean le Baptiste
ܨܠܝܒܐ	Croix
ܚܙܒܐܠܠܗ	Hezbollah
ܒܝܬ ܓܒܝܢܐ	Front (anatomie)
ܡܙܡܘܪܐ	Livre des Psaumes
ܐܬܘܪ	Assyrie
ܒܢܝܢܐ	Bâtiment (construction)
ܚܠܒ (ܡܕܝܢܬܐ)	Alep
ܩܫܬܐ ܬܝܡܢܝܬܐ ܕܐܪܥܐ	Hémisphère sud
ܚܠܐ (ܚܡܪܐ)	Vinaigre
ܒܝܬ ܕܝܢܐ	Tribunal
ܚܝܦܐ	Haïfa
ܫܛܪܐ ܬܐܒܝܠܝܐ ܕܓܝܢܝܣ	Livre Guinness des records
ܟܘܕܢܝܐ	Mulet
ܒܪܩܩܐ ܕܥܕܢ	Golfe d'Aden
ܓܠܝܢܐ ܕܝܘܚܢܢ	Apocalypse
ܐܫܬܐ (ܝܘܠܦܢ ܨܪܘܝܘܬܐ)	Fesse
ܨܠܘܬܐ ܡܪܝܡܝܬܐ	Je vous salue Marie
ܝܩܕܐ	Combustible
ܝܨܝܠܐ	Coude
ܟܗܢܐ	Prêtre
ܕܩܢܐ	Barbe
ܢܒܝܐ	Prophète
ܐܘܪܟܝܣܛܪܐ	Orchestre
1000 (ܡܢܝܢܐ)	1 000 (nombre)
ܣܘܦܝܐ ܪܘܛܐܪܘ	Sofia Rotaru
ܬܫܢܝܬܐ	Assurance
ܛܘܟܣܐ	Organisation
ܣܦܪܓܠܐ	Cognassier
ܐܢܕܪܐܘܣ ܫܠܝܚܐ	André (apôtre)
ܬܪܥܣܪ ܫܠܝܚܐ	Apôtre
ܢܩܒܬܐ	Femelle
ܕܪܥܐ (ܗܕܡܐ)	Bras (segment de membre)
ܡܬܝ ܡܟܣܐ	Matthieu (apôtre)
ܬܐܘܡܐ ܫܠܝܚܐ	Thomas (apôtre)
ܦܝܠܝܦܘܣ ܫܠܝܚܐ	Philippe (apôtre)
ܒܘܪܨܐ (ܗܘܦܪܟܝܐ)	Bursa (province)
ܐܝܘܐܢܢܝܣ ܦܘܡܐ ܕܕܗܒܐ	Jean Chrysostome
ܒܢܝܡܝܢ ܢܬܢܝܗܘ	Benyamin Netanyahou
ܐܪܬܒܝܢ (ܗܘܦܪܟܝܐ)	Artvin (province)
ܓܒܝܢܐ	Sourcil
ܫܘܪܬܐ	Nombril
ܐܕܝܐܡܐܢ (ܗܘܦܪܟܝܐ)	Adıyaman (province)
ܝܗܘܕܐ ܫܠܝܚܐ	Jude (apôtre)
ܒܪܬܘܠܡܝ ܫܠܝܚܐ	Barthélemy (apôtre)
ܝܥܩܘܒ ܒܪ ܙܒܕܝ	Jacques de Zébédée
ܝܘܚܢܢ ܫܠܝܚܐ	Jean (apôtre)
ܡܬܝܐ ܫܠܝܚܐ	Matthias (apôtre)
ܝܥܩܘܒ ܒܪ ܚܠܦܝ	Jacques d'Alphée
ܕܟܪܐ	Mâle (biologie)
ܐܝܓܢܐܛܝܘܣ ܢܘܪܢܐ	Ignace d'Antioche
ܪܕܝܘܗܕ	Radiohead
ܒܫܐܪ ܐܠܐܣܕ	Bachar el-Assad
ܪܚܝܐ	Moulin
ܨܘܡܐ	Jeûne
ܕܝܪܐ	Monastère
ܠܡܐܢܐ	Port
ܡܠܚܐ (ܢܘܛܐ)	Marin (profession)
ܐܦܝܘܢ (ܗܘܦܪܟܝܐ)	Afyonkarahisar (province)
ܡܝܟܐܝܠ (ܡܠܐܟܐ)	Michel (archange)
ܒܝܠܓܝܟ (ܗܘܦܪܟܝܐ)	Bilecik (province)
ܒܝܬ ܥܬܩܐ ܕܐܣܪܐܝܠ	Musée d'Israël
ܒܐܠܝܟܣܝܪ (ܗܘܦܪܟܝܐ)	Balıkesir (province)
ܒܝܬ ܝܠܕܐ	Anniversaire
ܬܘܠܥܐ	Ver
ܬܘܩܢ ܓܝܕܝܐ ܩܢܛܪܘܢܝܐ	Système nerveux central
ܛܘܪܐ ܕܓܠܝܕܐ	Iceberg
ܡܫܠܡܢܐ	Musulman
ܢܢܥܐ	Menthe
ܩܠܒܐ:Commonscat	Modèle:Commonscat
ܒܨܪܐ (ܡܕܝܢܬܐ)	Bassora
ܐܓܪܬܐ ܕܠܘܬ ܪܗܘܡܝܐ	Épître aux Romains
ܬܡܪܐ ܕܥܝܢܐ	Paupière
ܗܘܦܪܟܝܣ ܕܛܘܪܩܝܐ	Provinces de Turquie
ܡܪܝ ܓܝܘܪܓܝܣ ܣܗܕܐ	Georges de Lydda
ܐܣܘܬܐ ܕܠܐ ܬܚܘܡܐ	Médecins sans frontières
ܐܪܙܐ (ܡܫܝܚܝܘܬܐ)	Sacrement
ܐܓܪܬܐ ܕܠܘܬ ܦܝܠܝܦܣܝܐ	Épître aux Philippiens
ܐܢܛܘܠܝܐ	Anatolie
ܡܫܝܚܐ	Messie
ܚܫܡܝܬܐ ܐܚܪܝܬܐ	Cène
ܩܢܘܢܐ ܕܗܝܡܢܘܬܐ	Symbole des apôtres
ܒܢܝ ܐܝܣܪܐܝܠ	Tribus d'Israël
ܡܓܘܫܐ ܬܠܬܐ	Rois mages
ܝܘܚܢܢ ܕܪܡܣܘܩܝܐ	Jean Damascène
ܣܕܪܐ:ܡܠܟܐ	Catégorie:Roi
ܣܕܪܐ:ܪܘܟܒ ܫܘܠܛܢܘܬܐ	Catégorie:Régime politique
ܠܫܢܐ ܕܡܝܢ	Min (langue)
ܥܘܪܡܫܐ	Pollution
ܒܒܠ (ܗܘܦܪܟܝܐ)	Babil (province)
ܫܘܡܪܐ	Suie
ܐܫܩܠܘܢ	Ashkelon
ܕܘܢܒܐ	Queue (anatomie)
ܩܐܕܣܝܐ (ܗܘܦܪܟܝܐ)	Al-Qadisiyya (province)
ܡܪܝܡ ܡܓܕܠܝܬܐ	Marie de Magdala
ܡܪܪܬܐ	Vésicule biliaire
ܥܕܬܐ ܟܠܕܝܬܐ ܩܬܘܠܝܩܝܬܐ	Église catholique chaldéenne
ܥܕܬܐ ܡܪܘܢܝܬܐ	Église maronite
ܡܪܬܐ	Bile
ܩܘܪܒܢܐ	Eucharistie
ܐܕܡ	Adam
ܐܘܘܫܐ	Cérumen
ܕܡܥܬܐ	Larme
ܝܘܗܐܢ ܐܠܙܪ	Georg Elser
ܒܝܢܓܘܠ (ܗܘܦܪܟܝܐ)	Bingöl (province)
ܥܡܐ ܐܪܡܢܝܐ	Arméniens
ܐܝܕܝܢ (ܗܘܦܪܟܝܐ)	Aydın (province)
ܩܛܠܥܡܐ ܐܪܡܢܝܐ	Génocide arménien
ܐܡܐܣܝܐ (ܗܘܦܪܟܝܐ)	Amasya (province)
ܦܪܝܙܘܢ ܒܪܝܟ	Prison Break
ܐܓܪܝ (ܗܘܦܪܟܝܐ)	Ağrı (province)
ܒܘܪܕܘܪ (ܗܘܦܪܟܝܐ)	Burdur (province)
ܐܓܪܬܐ ܩܕܡܝܬܐ ܕܠܘܬ ܩܘܪܢܬܝܐ	Première épître aux Corinthiens
ܝܗܘܕܐ ܣܟܪܝܘܛܐ	Judas Iscariote
ܐܒܪܐ	Plume
ܡܚܪܐ	Ingénieur
ܚܪܛܘܡܢܐ	Pois chiche
ܐܬܪܘܬܐ ܕܫܐܡ	Levant (Proche-Orient)
ܬܪܘܕܐ	Cuillère
ܓܒܪܐܝܠ (ܡܠܐܟܐ)	Gabriel (archange)
ܓܪܡܦܝܠܐ	Ivoire
ܨܘܪ	Tyr
ܒܘܠܘ (ܗܘܦܪܟܝܐ)	Bolu (province)
ܙܢܩܐ	Menton (partie du visage)
ܨܘܡܐ ܕܐܪܒܥܝܢ	Carême
ܐܓܪܐ ܕܒܢܝܢܐ	Toit
ܒܝܛܠܝܣ (ܗܘܦܪܟܝܐ)	Bitlis (province)
ܓܠܝܠܐ	Galilée (région)
ܪܥܡܐ	Tonnerre
ܡܘܨܠ	Mossoul
ܟܪܬܐ	Pouce (anatomie)
ܥܡܐ ܛܘܪܩܝܐ	Turcs (peuple)
ܦܐܦܐ ܫܢܘܕܐ ܬܠܝܬܝܐ	Chenouda III d'Alexandrie
ܒܝܬ ܓܘܣܐ	Casemate
ܒܝܥܬܐ	Œuf (cuisine)
ܒܣܕܝܐ	Oreiller
ܙܓܐ (ܢܩܘܫܐ)	Cloche
ܫܒܬܐ (ܝܗܘܕܝܘܬܐ)	Chabbat
ܫܡܝܪܡ	Sémiramis
ܫܝܓܪܐ	Gencive
ܝܗ	YHWH
ܡܫܝܚܝܐ	Chrétien
ܟܪܘܙܘܬܐ ܕܡܪܩܘܣ	Évangile selon Marc
ܟܟܪܝܬܐ ܕܕܒܫܐ	Alvéole d'abeille
ܐܓܪܬܐ ܕܠܘܬ ܩܘܪܢܬܝܐ ܕܬܪܬܝܢ	Deuxième épître aux Corinthiens
ܫܥܘܬܐ (ܡܠܘܐܐ)	Cire
ܛܥܡܐ	Goût
ܓܢܬ ܫܒܪܐ	École maternelle
ܝܡܬܐ ܕܓܠܝܠܐ	Lac de Tibériade
ܕܝܘܬܐ	Encre
ܡܪܝ ܝܘܣܦ	Joseph (Nouveau Testament)
ܠܘܩܐ ܐܘܢܓܠܣܛܐ	Luc (évangéliste)
ܐܓܪܬܐ ܕܠܘܬ ܥܒܪܝܐ	Épître aux Hébreux
ܐܓܪܬܐ ܕܠܘܬ ܓܠܛܝܐ	Épître aux Galates
ܡܪܝ ܡܝܟܐܝܠ ܪܒܐ	Michel le Syrien
Ϝ	Digamma
Ϙ	Koppa
ܥܛܡܐ	Cuisse
ܬܢܢܐ	Fumée
ܡܘܚܘܢܐ	Cervelet
ܐܓܪܬܐ ܕܠܘܬ ܩܘܠܣܝܐ	Épître aux Colossiens
ܐܓܪܬܐ ܕܝܥܩܘܒ	Épître de Jacques
ܐܓܪܬܐ ܩܕܡܝܬܐ ܕܝܘܚܢܢ	Première épître de Jean
ܐܓܪܬܐ ܕܠܘܬ ܦܝܠܡܘܢ	Épître à Philémon
ܐܓܪܬܐ ܕܠܘܬ ܬܣܠܘܢܝܩܝܐ ܕܬܪܬܝܢ	Deuxième épître aux Thessaloniciens
ܐܓܪܬܐ ܩܕܡܝܬܐ ܕܠܘܬ ܬܣܠܘܢܝܩܝܐ	Première épître aux Thessaloniciens
ܐܓܪܬܐ ܩܕܡܝܬܐ ܕܦܛܪܘܣ	Première épître de Pierre
ܐܓܪܬܐ ܕܬܪܬܝܢ ܕܦܛܪܘܣ	Deuxième épître de Pierre
ܐܓܪܬܐ ܩܕܡܝܬܐ ܕܠܘܬ ܛܝܡܬܐܘܣ	Première épître à Timothée
Ϛ	Stigma
ܡܪܕܝܢ (ܗܘܦܪܟܝܐ)	Mardin (province)
ܚܡܨ (ܡܕܝܢܬܐ)	Homs
Ͳ	Sampi
ܘܐܟܐܩܐ ܕܝ ܟܘܐܪܝܣ	Oaxaca de Juárez
ܐܓܪܬܐ ܕܬܪܬܝܢ ܕܝܘܚܢܢ	Deuxième épître de Jean
ܐܓܪܬܐ ܕܬܠܬ ܕܝܘܚܢܢ	Troisième épître de Jean
ܐܓܪܬܐ ܕܝܗܘܕܐ	Épître de Jude
ܐܓܪܬܐ ܕܠܘܬ ܛܝܡܬܐܘܣ ܕܬܪܬܝܢ	Deuxième épître à Timothée
ܐܓܪܬܐ ܕܠܘܬ ܛܛܘܣ	Épître à Tite
ܫܝܪܢܐܟ (ܡܕܝܢܬܐ)	Şırnak
ܐܟܪܐ	Agriculteur
ܓܘܣܢܐ	Réfugié
Ϻ	San (lettre grecque)
ܩܠܝܕܐ (ܡܐܢܐ)	Clef (serrurerie)
ܥܕܥܐܕܐ	Festival
ܐܪܒܝܠ (ܡܕܝܢܬܐ)	Erbil
ܚܨܐ	Dos
ܐܠܝܐ ܢܒܝܐ	Élie
ܙܚܘܪܝܬܐ (ܬܘܠܥܬܐ)	Bombyx du mûrier
ܚܘܦܝܐ	Éclipse
ܡܚܛܐ	Aiguille à coudre
ܥܠܡܐ ܥܪܒܝܐ	Monde arabe
ܦܓܘܕܬܐ	Bride (équitation)
ܩܛܡܐ	Cendre
ܢܘܗܕܪܐ (ܡܕܝܢܬܐ)	Dahuk
ܨܒܥܐ ܕܪܓܠܐ	Orteil
ܢܓܪܘܬܐ	Charpentier
ܠܘܚܐ (ܚܫܘܒܬܐ)	Tablette tactile
ܪܒܝܬܐ	Usure (finance)
ܡܟܝܪܘܬܐ	Fiançailles
ܫܘܪܡܐ	Rectum
ܐܪܡܝܐ (ܢܒܝܐ)	Jérémie
ܬܐܡܐ	Jumeau
ܬܠܝܦܐ	Cil (anatomie)
ܫܥܬܐ ܕܐܪܥܐ	Earth Hour
ܦܪܡܝܬܐ	Bouton (couture)
ܟܘܟܒܐ ܕܕܘܝܕ	Étoile de David
ܡܪܝ ܐܣܛܦܢܘܣ	Étienne (martyr)
ܡܫܡܫܢܐ	Diacre (christianisme)
ܢܓܒ	Néguev
ܟܢܥܢ	Canaan (région)
ܢܘܨܦܐ	Crépuscule
ܒܝܢܐ	Tamarix
ܬܓܪܝܬ	Tikrit
ܚܠܐ (ܥܦܪܐ)	Poussière
ܬܪܥܐ ܕܕܡܐ	Hémorragie
ܥܪܒܐ ܕܫܡܫܐ	Coucher de soleil
ܐܡܝܫܐ	Marais
ܡܨܥܝܬܐ (ܨܒܥܐ)	Majeur (anatomie)
ز	Zāy
ܣܒܐ (ܒܝܬܝܘܬܐ)	Aïeul
ܩܘܪܨܠܐ	Cheville (anatomie)
ܒܪ ܐܝܕܐ	Gant
ܢܫܒܐ ܕܥܝܢܐ	Rétine
ܬܘܩܢ ܓܝܕܝܐ ܡܚܕܘܪܝܐ	Système nerveux périphérique
ܛܝܢܐ	Boue
ܓܓܘܠܬܐ	Golgotha
ܗܢܝܢܐ (ܡܡܫܚܘܬܐ)	Intérêt (finance)
ܐܫܘܪ ܒܢܐܦܠ	Assurbanipal
ܓܕܫܐ	Accident
ܦܛܪܝܪܟܐ	Patriarche (christianisme)
ا	Alif
ܚܟܐ	Palais (anatomie)
ت	Tāʾ
ث	Thā
ج	Jīm
ح	Ḥā
خ	Khā
د	Dāl
ذ	Dhāl
ر	Rā
ܪܓܫܐ	Sens (physiologie)
س	Sīn
ܟܪܟ ܣܠܘܟ (ܡܕܝܢܬܐ)	Kirkouk
ܒܒܬܐ	Pupille
ܩܒܪܐ	Tombe
ܠܒܘܢܬܐ	Encens (résine oliban)
ܚܡܬ (ܡܕܝܢܬܐ)	Hama
ܝܫܛܐ	Œsophage
ܟܝܣܐ ܕܐܫܟܐ	Scrotum
ܕܒܪܐ	Campagne
ܚܪܘܫܬܐ	Trachée
ܓܪܡܐ ܕܥܛܡܐ	Fémur
ܒܪܐ (ܒܝܬܝܘܬܐ)	Fils (parenté)
ܫܚܘܪܐ	Charbon de bois
ܐܘܟܡܐ ܕܥܝܢܐ	Iris (anatomie)
ܫܦܠܘܗܝ ܕܢܝܠܘܣ	Delta du Nil
ܐܘܪܡܝܐ	Ourmia
Ϸ	Sho
ܓܙܪܬܐ ܐܝܘܠܝܬܐ	Îles Éoliennes
ܓܒܐ ܕܒܥܬ	Parti Baas
ܦܩܪܐ	Vertèbre
ܒܪ ܩܠܐ	Écho (acoustique)
ܟܝܡܪܐ	Chimère (mythologie)
ܠܘܓܡܐ	Os maxillaire
ܛܪܘܢܐ	Dictateur (sens moderne)
ܬܝܒܘܬܐ	Confession
ܡܛܘܚܬܐ	Index (anatomie)
ܩܒܠܘܬܐ	Sage-femme
ܐܪܙܝܪܐ	Sturnidae
ܣܦܪܐ (ܩܢܘܢܝܐ)	Juriste
Ͱ	Hêta (lettre grecque)
ܥܡܐ ܐܪܡܝܐ	Araméens
ܟܢܘܢܬܐ (ܫܪܝܬܐ)	Poignet
ܐܒܐ (ܐܠܗܐ)	Dieu le Père
ܐܢܒܐܪ (ܗܘܦܪܟܝܐ)	Al-Anbar (province)
ܡܪܕܝܢ (ܡܕܝܢܬܐ)	Mardin
ܣܪܛܢܐ	Cancer (homonymie)
ܡܘܪܘܢ	Confirmation
ܚܠܡܬܐ	Mamelon
ܢܘܠܐ ܕܓܘܓܝ	Toile d'araignée
ܐܫܥܝܐ	Isaïe
ܒܝܬ ܟܬܒܐ ܐܬܪܝܐ ܕܐܣܪܐܝܠ	Bibliothèque nationale d'Israël
ܥܪܫܐ	Molaire (dent)
ܢܝܢܘܐ (ܗܘܦܪܟܝܐ)	Ninive (province)
ܢܘܗܕܪܐ (ܗܘܦܪܟܝܐ)	Dahuk (province)
ܘܐܣܛ (ܗܘܦܪܟܝܐ)	Wasit (province)
ܨܠܐܚ ܐܠܕܝܢ (ܗܘܦܪܟܝܐ)	Salah ad-Din (province)
ܟܢܘܫܝܐ ܕܠܫܢܐ ܥܒܪܝܐ	Académie de la langue hébraïque
ܥܘܕ	Oud
ܒܓܕܐܕ (ܗܘܦܪܟܝܐ)	Bagdad (province)
ܣܪܓܐ	Selle (équitation)
ܒܨܪܐ (ܨܒܥܐ)	Annulaire (anatomie)
ܩܛܝܣܦܘܢ	Ctésiphon
ܟܒܘܫܐ	Cauchemar
ܢܓܦ (ܗܘܦܪܟܝܐ)	An-Najaf (province)
ܟܪܟ ܣܠܘܟ (ܗܘܦܪܟܝܐ)	Kirkouk (province)
ܕܢܚܐ ܕܫܡܫܐ	Lever de soleil
ܒܨܪܐ (ܗܘܦܪܟܝܐ)	Al-Basra (province)
ܡܫܚܐ ܕܟܪܝܗܐ	Onction des malades
ܦܠܫܬ	Philistins
ܐܠܥܐ (ܝܘܠܦܢ ܨܪܘܝܘܬܐ)	Côte (os)
ܥܕܬܐ ܐܝܓܘܦܛܝܬܐ	Église copte orthodoxe
ܐܦܪܝܡ ܣܘܪܝܝܐ	Éphrem le Syrien
ܪܝܫܘܢ ܠܬܣܝܘܢ	Rishon LeZion
ܟܢܪܐ	Lyre
ܥܕܬܐ ܕܡܕܢܚܐ ܕܐܬܘܪܝܐ	Église apostolique assyrienne de l'Orient
ܬܠܐ ܕܚܕ ܐܝܠܢ	Les Frères Scott
ܡܘܪܐ	Myrrhe
ܦܕܪܠܝܐ	Fédéralisme
ܐܠܝܫܥ	Élisée
ܗܟܐܪܝ (ܡܕܝܢܬܐ)	Hakkari
ܣܢܚܪܝܒ	Sennacherib
ܩܘܪܝܐܠܝܣܘܢ	Kyrie
ܟܢܘܫܝܐ ܕܐܣܪܐܝܠ ܕܝܘܠܦܢܐ ܘܐܢܫܝܬܐ	Académie israélienne des sciences et lettres
ܣܘܟܢܐ	Gouvernail
ܥܕܬܐ ܣܘܪܝܝܬܐ ܐܪܬܘܕܟܣܝܬܐ	Église syriaque orthodoxe
ܟܣܬܐ	Fourrage
ܩܡܫܠܝ	Kameshli
ܡܘܬܢܐ (ܗܘܦܪܟܝܐ)	Al-Muthanna
ܡܝܫܢ (ܗܘܦܪܟܝܐ)	Maysan
ܣܘܠܝܡܐܢܝܐ (ܗܘܦܪܟܝܐ)	As-Sulaymaniya
ܐܪܒܝܠ (ܗܘܦܪܟܝܐ)	Arbil (province)
ܚܠܒ (ܗܘܦܪܟܝܐ)	Gouvernorat d'Alep
ܟܪܒܠܐܐ (ܗܘܦܪܟܝܐ)	Karbala (province)
ܕܝ ܩܐܪ (ܗܘܦܪܟܝܐ)	Dhi Qar
ܐܢܕܪܢܝܩ ܡܐܪܓܐܪܝܐܢ	Andranik Margarian
ܡܡܠܠܘܬ ܐܠܗܘܬܐ	Théologie chrétienne
ܓܘܙܐ	Juglandaceae
ܕܝܐܠܐ (ܗܘܦܪܟܝܐ)	Diyala (province)
ܟܒܒ	Khabab
ش	Shīn
ܩܪܫܬܐ	Plafond (architecture)
ص	Ṣād
ض	Ḍād
ظ	Ẓāʾ
ع	ʿAyn
غ	Ġayn
ف	Fāʾ
ق	Qāf
ܚܨܪܐ	Auriculaire (anatomie)
ܐܡܬܐ (ܝܘܠܦܢ ܨܪܘܝܘܬܐ)	Avant-bras
ܣܝܢܝ	Sinaï (homonymie)
ܬܐܘܡܐ	Thomas
ܐܝܒܪܝܐ	Iberia (homonymie)
ܚܡܬ (ܗܘܦܪܟܝܐ)	Gouvernorat de Hama
ܟܢܘܢܬܐ ܕܐܝܕܐ	Carpe (anatomie)
ܐܝܣܪܐܝܠ (ܬܘܚܡܐ ܐܚܪܢܐ)	Israël (homonymie)
ܡܠܐܟܐ	Ange
ܫܢܬܐ ܦܫܝܛܬܐ	Année commune
ܡܣܘܪܩܐ ܕܐܝܕܐ	Métacarpe
ܡܠܟܘܬܐ ܕܒܝܬ ܥܣܪ ܥܝܢܐ	Osroène
ܕܪܥܐ (ܡܕܝܢܬܐ)	Deraa
ܨܕܥܐ	Tempe (anatomie)
ܣܘܣܝܐ ܐܝܣܠܢܕܝܐ	Islandais (cheval)
ܩܠܐ	Note de musique
ܛܘܘܝܐ	Grillade
ܓܪܡܐ	Os
ܒܪܝܐܢܝ	Biryani
ܠܒܠܒܬܐ	Luette
ܙܓܐ ܕܣܦܝܢܬܐ	Cloche de navire
ك	Kāf
ل	Lām
م	Mīm
ن	Nūn
ه	Hā
و	Wāw
ي	Yā
ܥܪܒܝܐ	Arabe (homonymie)
ܓܝܕܐ ܕܓܢܫܝܐ	Nerf ischiatique
ܒܪܬܐ (ܒܝܬܝܘܬܐ)	Fille (parenté)
ܗܪܗܪܐ	Mirage
ܚܣܟܗ (ܡܕܝܢܬܐ)	Hassaké
ܛܐܪܩ ܥܙܝܙ	Tarek Aziz
ܡܣܘܪܩܐ ܕܪܓܠܐ	Métatarse
ܥܪܩ	Arak (boisson)
ܫܠܦܐ	Lame (coutellerie)
ܛܘܪ ܠܒܢܢ	Mont Liban
ܐܙܟ	İdil
ܐܘܛܪܝܟܛ	Utrecht (homonymie)
ܟܝܢܐ	Nature (homonymie)
ܡܪܝ ܐܕܝ ܬܪܝܢܐ	Addai II de Bagdad
ܪܗܘܡܐ	Rum
ܩܝܒܩ	Québec (homonymie)
ܩܕܠܐ	Nuque
ܥܡܐ ܐܬܘܪܝܐ/ܣܘܪܝܝܐ	Assyriens
ܛܘܪܐ ܕܣܝܢܝ	Mont Sinaï
ܦܘܪܬܥܢܐ	Siphonaptera
ܫܡܣܕܝܢ	Şemdinli
ܟܪܘܙܘܬܐ ܕܡܬܝ	Évangile selon Matthieu
ܡܕܝܢܬܐ ܡܝܬܬܐ	Villages antiques du Nord de la Syrie
ܐܓܪܬܐ ܕܠܘܬ ܐܦܣܝܐ	Épître aux Éphésiens
ܚܡܬ	Hama (homonymie)
10000 (ܡܢܝܢܐ)	10 000 (nombre)
ܒܢܦܫܐ	Violet
ܢܨܪܬ	Nazareth
ܥܕܬܐ ܥܬܝܩܬܐ ܕܡܕܢܚܐ	Ancienne Église de l'Orient
ܟܬܒܐ ܕܡܘܪܡܘܢ	Livre de Mormon
ܐܝܓܢܐܛܝܘܣ ܡܘܫܐ ܩܕܡܝܐ ܕܐܘܕ	Ignace Moussa Ier Daoud
ܒܫܐܪܐ ܦܛܪܘܣ ܐܠܪܐܥܝ	Bechara Boutros Rahi
ܥܡܢܘܐܝܠ ܬܠܝܬܝܐ ܕܠܝ	Emmanuel III Karim Delly
ܥܡܘ ܒܒܐ	Ammo Baba
ܥܡܘܕܐ ܦܩܪܝܐ	Colonne vertébrale
ܒܝܬ ܫܥܝܐ	Stade
ܓܘܕ ܫܪܠܘܛ	Good Charlotte
ܒܪ ܨܘܪܐ	Col (vêtement)
ܚܣܚܘܣܐ	Cartilage
ܛܘܪ ܥܒܕܝܢ	Tur Abdin
ܡܪܝ ܩܘܪܝܩܘܣ ܣܗܕܐ ܘܕܝܘܠܝܛܐ ܝܡܗ	Cyr de Tarse
ܐܝܣܛܢܒܘܠ (ܗܘܦܪܟܝܐ)	Istanbul (province)
ܝܘܢܝܐ	Grecs
ܓܗܢܐ	Géhenne
ܝܥܩܘܒ ܒܘܪܕܥܢܐ	Jacques Baradée
ܐܓܢܛܝܘܣ ܝܘܣܦ ܬܠܝܬܝܐ ܝܘܢܢ	Ignace Joseph III Younan
ܡܪܝ ܕܢܚܐ ܪܒܝܥܝܐ	Dinkha IV
ܬܠܫܝܬܐ ܕܩܛܠܐ ܕܐܕܘܠܦ ܗܝܛܠܪ	Attentats contre Adolf Hitler
ܚܟܐܪܝ	Hakkiari
ܬܐܓܘܪܬܐ	Commerce
ܡܪܝ ܐܦܪܝܡ	Aprem Mooken
ܡܬܐ	Heimat
ܫܝܪܢܐܟ (ܗܘܦܪܟܝܐ)	Şırnak (province)
ܥܘܩܣܐ	Dard (biologie)
ܟܗܢܘܬܐ	Ordre (sacrement)
ܚܒܘܪ	Khabur
ܗܕܡܐ ܓܘܝܐ	Organe
ܚܡܬܐ (ܒܝܬܝܘܬܐ)	Belle-mère
ܡܥܠܘܠܐ	Maaloula
ܐܘܪܘܦܐ	Europa
ܡܕܝܕ	Midyad
ܐܣܝܪܝܣܩܐ	Assyriska FF
ܥܕܬܐ ܣܘܪܝܝܬܐ ܩܬܘܠܝܩܝܬܐ	Église catholique syriaque
ܐܘܣܛܪܠܝܐ	Australia
ܡܦܩܬܐ ܦܫܝܛܬܐ	Peshitta
ܐܪܚܘܬܐ	Hospitalité
ܫܪܓܐ ܕܢܦܛܐ	Lampe à huile
ܚܘܐ	Ève
ܗܘܦܪܟܝܣ ܕܥܝܪܐܩ	Gouvernorats de l'Irak
ܩܛܠܥܡܐ ܐܬܘܪܝܐ	Génocide assyrien
ܒܝܬ ܟܬܒܐ ܕܐܫܘܪ ܒܢܐܦܠ	Bibliothèque d'Assurbanipal
ܣܪܦܝܘܢ	Sérapion de Thmuis
ܒܕܘܩܐ	Scoutisme
ܥܘܕܪܢܐ:ܚܒܝܫܬ̈ܐ	Aide:Sommaire
ܓܦܬܐ	Plante grimpante
ܡܝܟܐܝܠ	Michael
ܙܒܐ	Petit Zab
ܐܝܓܢܐܛܝܘܣ ܙܟܝ ܩܕܡܝܐ ܥܝܘܐܨ	Ignace Zakka Ier Iwas d'Antioche
ܐܣܛܘܡܟܐ	Estomac
ܟܢܘܢܬܐ ܕܪܓܠܐ	Tarse (anatomie)
ܚܡܐ (ܒܝܬܝܘܬܐ)	Beau-père
ܓܢܬܐ	Jardin
ܕܪܓܘܫܬܐ	Berceau
ܒܪܐ (ܐܠܗܐ)	Dieu le Fils
ܚܝܠܐ ܠܒܢܝܐ	Forces libanaises
ܐܠܩܘܫ	Alqosh
ܐܘܪܗܝ	Édesse (chrétienne)
ܢܩܘܫܐ	Simandre (liturgie)
ܘܝܩܝܦܕܝܐ:ܐܝܙܓܕܘܬܐ	Wikipédia:Ambassade
ܫܠܝܬܐ	Placenta
ܕܘܢܝ ܓܘܪܓ ܝܘܚܢܢ	Donny George
ܒܝܬ ܛܘܣܐ	Aéroport
ܒܝܬ ܫܡܪܝܐ	Samarie
ܐܓܢܣ ܡܘ	Agnes Monica
ܪܘܦܐܝܠ ܩܕܡܝܐ ܒܝܬ ܕܘܝܕ	Raphaël Ier Bidawid
ܣܕܪܐ:ܓܪܡܢ	Catégorie:Allemagne
ܣܕܪܐ:ܐܝܛܠܝܐ	Catégorie:Italie
ܣܕܪܐ:ܐܬܪܘܬܐ ܡܚܝܕܐ ܕܐܡܪܝܩܐ	Catégorie:États-Unis
ܣܕܪܐ:ܪܘܣܝܐ	Catégorie:Russie
ܣܕܪܐ:ܩܢܕܐ	Catégorie:Canada
ܣܕܪܐ:ܐܝܣܪܐܝܠ	Catégorie:Israël
ܣܕܪܐ:ܛܘܪܩܝܐ	Catégorie:Turquie
ܣܕܪܐ:ܡܨܪܝܢ	Catégorie:Égypte
ܣܕܪܐ:ܐܝܪܐܢ	Catégorie:Iran
ܕܝܪܐ ܕܡܪܝ ܓܒܪܐܝܠ	Monastère Mor Gabriel
ܥܐܕܐ	Jour férié
ܣܕܪܐ:ܥܝܪܐܩ	Catégorie:Irak
ܣܕܪܐ:ܗܘܠܢܕܐ	Catégorie:Pays-Bas
ܣܕܪܐ:ܦܘܠܢܕ	Catégorie:Pologne
ܣܕܪܐ:ܛܝܪܐ	Catégorie:Oiseau
ܣܕܪܐ:ܝܥܝܬܐ	Catégorie:Plante
ܣܕܪܐ:ܬܘܕܝܬܐ	Catégorie:Religion
ܣܕܪܐ:ܝܕܥܬܐ	Catégorie:Sciences
ܩܘܠ ܬܘܪܗ	Yechiva Kol Tora
ܦܪܡܬܐ ܕܣܡܠܐ	Massacre de Simele
ܓܪܫܘܢܝ	Garshouni
ܨܘܒܐ	Nusaybin
ܕܪܥܐ (ܗܘܦܪܟܝܐ)	Gouvernorat de Deraa
ܣܕܪܐ ܕܦܛܪܝܪܟܐ ܕܥܕܬܐ ܕܡܕܢܚܐ	Liste des primats de l'Église apostolique assyrienne de l'Orient
ܕܝܪܐ ܕܟܘܪܟܡܐ	Monastère Mor Hananyo
ܢܩܘܕ	Diacritiques de l'alphabet hébreu
ܡܪܝܡ (ܚܬܗ ܕܡܘܫܐ)	Myriam
ܨܡܘܪܬܐ	Croc (dent)
ܡܪܝ ܬܐܘܡܐ ܕܪܡܘ	Thoma Darmo de Bagdad
ܣܕܪܐ:ܡܫܝܚܝܘܬܐ	Catégorie:Christianisme
ܣܕܪܐ:ܐܣܠܐܡ	Catégorie:Islam
ܣܕܪܐ:ܝܗܘܕܝܘܬܐ	Catégorie:Judaïsme
ܠܩܐ ܕܣܦܝܢܬܐ	Aviron (rame)
ܚܪܒܘܩܬܐ	Boutonnière (couture)
ܫܡܥܘܢ ܒܪܨܒܥܐ	Simon bar Sabbae
ܬܪܢܓܠܐ	Coq
ܙܚܘܪܝܬܐ (ܓܘܢܐ)	Écarlate
ܐܢܩܪܐ (ܗܘܦܪܟܝܐ)	Ankara (province)
ܐܢܕܪܐܘܣ	André
ܐܝܪܠܢܕ	Ireland
ܟܬܒܬ ܐܝܕܐ	Écriture manuscrite
ܝܘܢܢ	Jonas
ܫܡܐ ܕܝܠܝܕܘܬܐ	Nom de naissance
ܐܨܪܐ	Condiment
ܕܝܪܝܟ	Al-Malikiyah
ܡܪܩܩܐ	Hypocondre
ܐܓܐ ܦܛܪܘܣ	Agha Petros
ܥܝܒܐ	Nimbus (nuage)
ܫܘܫܡܬܐ	Sésame
ܒܝܬ	Bēth
ܣܕܪܐ:ܘܝܩܝܦܕܝܐ	Catégorie:Espace Catégorie
ܣܕܪܐ:ܝܒܫܬܐ	Catégorie:Continent
ܒܓܕܝܕܐ	Bakhdida
ܕܠܬ	Dālath
ܦܘܙܝ ܗܪܝܪܝ	Faouzi al-Hariri
ܓܡܠ	Gāmal
ܗܐ	Hē
ܝܙܦܬܐ	Dette
ܦܨܝܕܐ	Étang
ܐܪܓܘܢܐ	Pourpre
ܠܡܕ	Lāmadh
ܡܝܡ	Mīm (syriaque)
ܢܘܢ	Nūn (syriaque)
ܢܘܪܢܝܐ	Pyramide
ܦܐ	Pē
ܩܘܦ	Qōph
ܪܝܫ	Rēš
ܣܡܟܬ	Semkath
ܘܐܘ	Waw (syriaque)
ܙܝܢ	Zain (lettre)
ܫܝܢ	Šīn
ܐܠܦ	ʿĀlaph
ܨܕܐ	Ṣādhē
ܛܝܬ	Ṭēth
ܒܛܐ	Canard
ܗܝܟܠܐ ܕܫܠܝܡܘܢ	Temple de Jérusalem
ܠܘܝܣ ܪܘܦܐܝܠ ܩܕܡܝܐ ܣܟܘ	Louis Raphaël Ier Sako
ܩܠܒܐ:ܓܕܫܐ ܗܫܝܐ	Modèle:Accueil actualité
ܣܕܪܐ:ܡܟܬܒܢܘܬܐ ܕܐܬܪܘܬܐ	Catégorie:Pays
ܘܝܩܝܦܕܝܐ:ܡܕܒܪܢܐ	Wikipédia:Administrateur
ܣܕܪܐ:ܫܕܬܐ	Catégorie:Métier
ܘܝܩܝܦܕܝܐ:ܒܘܬ̈ܐ	Wikipédia:Bot
ܣܕܪܐ:ܙܒܢܐ	Catégorie:Temps
ܣܕܪܐ:ܝܘܠܦܢ ܨܪܘܝܘܬܐ	Catégorie:Anatomie
ܣܕܪܐ:ܐܣܝܘܬܐ	Catégorie:Médecine
ܡܨܪܝܢ	Égypte
ܩܠܒܐ:Bot	Modèle:Bot
ܩܢܕܐ	Canada
ܣܕܪܐ:ܝܘܢ	Catégorie:Grèce
ܣܕܪܐ:ܣܘܝܕ	Catégorie:Suède
ܐܡܪܐ	Agneau
ܩܠܒܐ:ܐܫܛܪܘܬܐ	Modèle:Documentation
ܣܕܪܐ:User languages	Catégorie:Wikipédiens par langue
ܦܘܠܚܢܐ	Entreprise
ܩܠܒܐ:Softredirect	Modèle:Redirection douce
ܩܠܒܐ:Delete	Modèle:Suppression Immédiate
ܒܪܒܥܫܡܝܢ	Bar Bashmin
ܡܓܕܠܐ (ܩܪܝܬܐ)	Magdala (Israël)
ܣܕܪܐ:ܛܟܢܘܠܘܓܝܐ	Catégorie:Technologie
ܓܒܪܐܝܠ (ܫܡܐ)	Gabriel
ܣܕܪܐ:ܠܫܢܐ	Catégorie:Langue
ܣܕܪܐ:ܩܢܘܢܐ ܕܠܥܙܐ	Catégorie:Grammaire
ܘܝܩܝܦܕܝܐ:General disclaimer	Wikipédia:Avertissements généraux
ܡܪܘܢܝܐ	Maronites
ܘܝܩܝܦܕܝܐ:ܕܘܒܪܐ	Wikipédia:Conventions de style
ܩܠܒܐ:Navbox	Modèle:Méta palette de navigation
ܐܝܓܢܐܛܝܘܣ ܐܦܪܝܡ ܬܪܝܢܐ	Ignace Ephrem II Karim
ܩܠܒܐ:!	Modèle:!
ܣܕܪܐ:ܩܠܒܐ ܐܬܘܬܐ ܕܐܝܣܘ	Catégorie:Modèle drapeau
ܩܠܒܐ:ܡܦܐܬܐ ܩܠܒܐ	Modèle:Tnavbar
ܩܠܒܐ:Clear	Modèle:Clr
ܘܝܩܝܦܕܝܐ:ܡܟܬܒܘܬܐ ܕܡܓܠܐ ܠܟܠ ܘܝܩܝܦܕܝܐ	Wikipédia:Articles vitaux
ܣܕܪܐ:ܐܠܝܩܛܪܘܢܝܘܬܐ	Catégorie:Électronique
ܣܕܪܐ:ܝܪܚܐ ܕܫܢܬܐ	Catégorie:Mois
ܩܠܒܐ:Babel	Modèle:Boîte Babel
ܩܠܒܐ:Commons	Modèle:Commons
ܩܠܒܐ:Reflist	Modèle:Références
ܩܠܒܐ:User ar-1	Modèle:Utilisateur ar-1
ܩܠܒܐ:User az	Modèle:Utilisateur az
ܩܠܒܐ:See also	Modèle:Article connexe
ܩܠܒܐ:User de	Modèle:Utilisateur de
ܩܠܒܐ:User es	Modèle:Utilisateur es
ܩܠܒܐ:User en-3	Modèle:Utilisateur en-3
ܩܠܒܐ:User en-1	Modèle:Utilisateur en-1
ܩܠܒܐ:User en-2	Modèle:Utilisateur en-2
ܩܠܒܐ:User en-4	Modèle:Utilisateur en-4
ܩܠܒܐ:User en-0	Modèle:Utilisateur en-0
ܩܠܒܐ:User en	Modèle:Utilisateur en
ܩܠܒܐ:User fa	Modèle:Utilisateur fa
ܩܠܒܐ:User fr-1	Modèle:Utilisateur fr-1
ܩܠܒܐ:User he-2	Modèle:Utilisateur he-2
ܩܠܒܐ:User he-1	Modèle:Utilisateur he-1
ܩܠܒܐ:User sk	Modèle:Utilisateur sk
ܩܠܒܐ:User tr	Modèle:Utilisateur tr
ܩܠܒܐ:User ja	Modèle:Utilisateur ja
ܩܠܒܐ:User fr	Modèle:Utilisateur fr
ܩܠܒܐ:User he	Modèle:Utilisateur he
ܣܕܪܐ:ܐܣܝܐ	Catégorie:Asie
ܣܕܪܐ:ܕܪܐ ܕܥܣܪܝܢ ܘܚܕ	Catégorie:XXIe siècle
ܩܠܒܐ:Mod	Modèle:Mod
ܩܠܒܐ:User sv	Modèle:Utilisateur sv
ܩܠܒܐ:Infobox language/codelist	Modèle:Lien ISO 639-3
ܩܠܒܐ:User it	Modèle:Utilisateur it
ܣܕܪܐ:ܝܘܡܐ ܕܫܒܘܥܐ	Catégorie:Jour de la semaine
ܣܕܪܐ:ܐܨܪܐ	Catégorie:Condiment
ܩܠܒܐ:ܝܗܘܝܬܐ Peru	Modèle:Country data Pérou
ܩܠܒܐ:ܝܗܘܝܬܐ Paraguay	Modèle:Country data Paraguay
ܩܠܒܐ:Edit	Modèle:Éditer
ܩܠܒܐ:ܝܗܘܝܬܐ French Guiana	Modèle:Country data Guyana
ܩܠܒܐ:ܝܗܘܝܬܐ Argentina	Modèle:Country data Argentine
ܩܠܒܐ:ܡܟܬܒܢܘܬܐ ܕܝܦܬܐ	Modèle:Collapsible list
ܩܠܒܐ:Ambox	Modèle:Méta bandeau d'avertissement
ܩܠܒܐ:Navigation templates	Modèle:Palette Modèles navigationnels
ܩܠܒܐ:ܐܬܪܐ	Modèle:Infobox Pays
ܣܕܪܐ:User en	Catégorie:Utilisateur en
ܣܕܪܐ:User zh	Catégorie:Utilisateur zh
ܩܠܒܐ:ܐܠܦܒܝܬ ܥܪܒܝܐ	Modèle:Palette Alphabet arabe
ܣܕܪܐ:User zh-N	Catégorie:Utilisateur zh-M
ܩܠܒܐ:User zh	Modèle:Utilisateur zh
ܩܠܒܐ:ܩܠܒܐ ܐܚܪܝܢܐ	Modèle:Template other
ܣܕܪܐ:ܦܐܦܐ	Catégorie:Pape
ܩܠܒܐ:Pp-template	Modèle:Protection
ܩܠܒܐ:User nl-1	Modèle:Utilisateur nl-1
ܩܠܒܐ:User nl-2	Modèle:Utilisateur nl-2
ܩܠܒܐ:User ru	Modèle:Utilisateur ru
ܩܠܒܐ:IPA	Modèle:Prononciation API
ܣܕܪܐ:ܗܪܘܡܐ	Catégorie:Épice
ܣܕܪܐ:ܦܠܫܬ	Catégorie:Palestine
ܣܕܪܐ:ܡܠܐܟܐ	Catégorie:Ange
ܣܕܪܐ:ܢܒܝܐ	Catégorie:Prophète
ܩܠܒܐ:Rellink	Modèle:Rellink
ܩܠܒܐ:Category redirect	Modèle:Catégorie redirigée
ܩܠܒܐ:ܝܗܘܝܬܐ Venezuela	Modèle:Country data Venezuela
ܩܠܒܐ:ܨܢܕܘܩ ܡܕܒܪܢܐ	Modèle:Infobox Politicien
ܩܠܒܐ:Sortname	Modèle:TriNom
ܩܠܒܐ:Border	Modèle:Bordure
ܩܠܒܐ:ܡܢܝܢܐ ܕܝܪܚܐ	Modèle:MONTHNUMBER
ܩܠܒܐ:ܝܗܘܝܬܐ Chile	Modèle:Country data Chili
ܩܠܒܐ:GUA	Modèle:Guatemala
ܩܠܒܐ:User nl	Modèle:Utilisateur nl
ܩܠܒܐ:ܡܣܦܩ ܩܐܫ	Modèle:Purger le cache
ܩܠܒܐ:ܨܢܕܘܩ ܐܡܢܐ	Modèle:Infobox Artiste
ܩܠܒܐ:ܡܦܠܚܢܐ	Modèle:U
ܣܕܪܐ:ܬܘܢܣ	Catégorie:Tunisie
ܩܠܒܐ:Oppose	Modèle:Contre
ܩܠܒܐ:COL	Modèle:Colombie
ܩܠܒܐ:PER	Modèle:Pérou
ܩܠܒܐ:ܨܢܕܘܩ ܡܕܥܐ ܕܝܒܫܬܐ	Modèle:Infobox Continent
ܩܠܒܐ:User ar-2	Modèle:Utilisateur ar-2
ܩܠܒܐ:User ar-3	Modèle:Utilisateur ar-3
ܩܠܒܐ:User ar	Modèle:Utilisateur ar
ܩܠܒܐ:ܝܘܡܐ ܕܫܒܘܥܐ	Modèle:Palette Jours de la semaine
ܣܕܪܐ:ܡܕܝܢܬܐ ܒܐܘܚܕܢܐ ܡܚܝܕܐ	Catégorie:Ville des États-Unis
ܩܠܒܐ:ܬ.ܐ.	Modèle:Homonymie
ܩܠܒܐ:No	Modèle:Pas fait.
ܣܕܪܐ:ܩܠܒܐ ܨܢܕܘܩܐ	Catégorie:Modèle infobox
ܩܠܒܐ:ܐܠܦܒܝܬ ܣܘܪܝܝܐ	Modèle:Palette Alphabet syriaque
ܩܠܒܐ:ܩܘܕܝܟܘܣ ܕܣܕܪܐ	Modèle:Boîte des catégories
ܩܠܒܐ:ܝܗܘܝܬܐ Colombia	Modèle:Country data Colombie
ܩܠܒܐ:User ar-5	Modèle:Utilisateur ar-5
ܣܕܪܐ:User yue	Catégorie:Utilisateur zh-yue
ܣܕܪܐ:User az	Catégorie:Utilisateur az
ܣܕܪܐ:User sk	Catégorie:Utilisateur sk
ܣܕܪܐ:User fr	Catégorie:Utilisateur fr
ܣܕܪܐ:User ja	Catégorie:Utilisateur ja
ܣܕܪܐ:User la	Catégorie:Utilisateur la
ܣܕܪܐ:User pt	Catégorie:Utilisateur pt
ܣܕܪܐ:User ro	Catégorie:Utilisateur ro
ܣܕܪܐ:User sv	Catégorie:Utilisateur sv
ܣܕܪܐ:User ko-N	Catégorie:Utilisateur ko-M
ܩܠܒܐ:User yue	Modèle:Utilisateur yüt
ܣܕܪܐ:ܗܘܦܪܟܝܣ ܕܥܝܪܐܩ	Catégorie:Province d'Irak
ܩܠܒܐ:Cat main	Modèle:Article principal
ܣܕܪܐ:User ar	Catégorie:Utilisateur ar
ܣܕܪܐ:User arc	Catégorie:Utilisateur arc
ܣܕܪܐ:User da	Catégorie:Utilisateur da
ܣܕܪܐ:User sk-N	Catégorie:Utilisateur sk-M
ܣܕܪܐ:User de	Catégorie:Utilisateur de
ܣܕܪܐ:User el	Catégorie:Utilisateur el
ܣܕܪܐ:User en-N	Catégorie:Utilisateur en-M
ܣܕܪܐ:User es	Catégorie:Utilisateur es
ܣܕܪܐ:User fa	Catégorie:Utilisateur fa
ܣܕܪܐ:User fi	Catégorie:Utilisateur fi
ܣܕܪܐ:User he	Catégorie:Utilisateur he
ܩܠܒܐ:N/a	Modèle:N/A
ܣܕܪܐ:User hy	Catégorie:Utilisateur hy
ܣܕܪܐ:ܠܫܢܐ ܥܒܪܝܐ	Catégorie:Langue hébraïque
ܣܕܪܐ:ܡܕܝܢܬܐ ܒܐܝܣܪܐܝܠ	Catégorie:Ville d'Israël
ܣܕܪܐ:User it	Catégorie:Utilisateur it
ܣܕܪܐ:User ko	Catégorie:Utilisateur ko
ܣܕܪܐ:ܒܬܫܪܝܢ ܐܚܪܝ	Catégorie:Novembre
ܣܕܪܐ:ܝܡܡܐ	Catégorie:Mer
ܩܠܒܐ:No2	Modèle:Non2
ܣܕܪܐ:ܦܛܪܝܪܟܘ ܕܥܕܬܐ ܣܘܪܝܝܬܐ ܩܬܘܠܝܩܝܬܐ	Catégorie:Patriarche catholique syriaque d'Antioche
ܩܠܒܐ:Languages	Modèle:Palette Utilisateur Langues
ܩܠܒܐ:Rh	Modèle:Rh
ܩܠܒܐ:ܡܢܝܢܐ ܕܡܡܪܐ ܦܪܝܫܐ	Modèle:Nombre d'articles de qualité
ܩܠܒܐ:User tmr-3	Catégorie:Utilisateur tmr-3
ܩܠܒܐ:ܣܡܘܩܐ	Modèle:Rouge
ܩܠܒܐ:ܝܗܘܝܬܐ Brazil	Modèle:Country data Brésil
ܩܠܒܐ:Yes2	Modèle:Oui2
ܩܠܒܐ:Yes-No	Modèle:Yes-Not
ܬܪܥܐ:ܬܘܕܝܬܐ	Portail:Religions et croyances
ܣܕܪܐ:User ru	Catégorie:Utilisateur ru
ܣܕܪܐ:User ru-3	Catégorie:Utilisateur ru-3
ܣܕܪܐ:User templates ar	Catégorie:Langue pour les boîtes utilisateurs/ar
ܣܕܪܐ:User templates arc	Catégorie:Langue pour les boîtes utilisateurs/arc
ܣܕܪܐ:User templates en	Catégorie:Langue pour les boîtes utilisateurs/en
ܣܕܪܐ:User templates he	Catégorie:Langue pour les boîtes utilisateurs/he
ܣܕܪܐ:User tl	Catégorie:Utilisateur tl
ܣܕܪܐ:User tmr	Catégorie:Utilisateur tmr
ܣܕܪܐ:User tr	Catégorie:Utilisateur tr
ܣܕܪܐ:ܙܡܪܐ	Catégorie:Musicien
ܩܠܒܐ:Lang	Modèle:Langue
ܣܕܪܐ:ܪܫܘܡܐ	Catégorie:Peintre
ܩܠܒܐ:Busy/Doc	Modèle:Wikibreak débordé
ܣܕܪܐ:ܐܡܢܐ ܥܠ ܐܕܫܐ	Catégorie:Métier par secteur
ܩܠܒܐ:ܚܡܫܐ ܐܘܩܝܢܘ	Modèle:Palette Océans
ܩܠܒܐ:CHI	Modèle:Chili
ܩܠܒܐ:Cat handler/numbered	Modèle:Cat handler/numbered
ܣܕܪܐ:ܢܝܓܪ	Catégorie:Niger
ܣܕܪܐ:ܦܛܪܝܪܟܘ ܕܥܕܬܐ ܕܡܕܢܚܐ	Catégorie:Patriarche de l'Église de l'Orient
ܩܠܒܐ:Infobox language/family-color	Projet:Charte graphique/Tableau des langues
ܩܠܒܐ:User ar-0	Modèle:Utilisateur ar-0
ܣܕܪܐ:ܣܥܪܐ	Catégorie:Coiffure
ܩܠܒܐ:User ar-4	Modèle:Utilisateur ar-4
ܣܕܪܐ:ܢܗܪܘܬܐ	Catégorie:Rivière
ܩܠܒܐ:User he-0	Modèle:Utilisateur he-0
ܩܠܒܐ:User he-3	Modèle:Utilisateur he-3
ܩܠܒܐ:User he-4	Modèle:Utilisateur he-4
ܩܠܒܐ:User ko	Modèle:Utilisateur ko
ܩܠܒܐ:User pt	Modèle:Utilisateur pt
ܣܕܪܐ:User nl	Catégorie:Utilisateur nl
ܣܕܪܐ:User no	Catégorie:Utilisateur no
ܣܕܪܐ:ܣܘܪܝܐ	Catégorie:Syrie
ܣܕܪܐ:ܕܪܐ ܩܕܡܝܐ	Catégorie:Ier siècle
ܣܕܪܐ:ܓܙܪܬܐ ܝܒܫܢܝܬܐ	Catégorie:Péninsule
ܣܕܪܐ:ܗܘܦܪܟܝܣ ܕܗܘܠܢܕܐ	Catégorie:Province des Pays-Bas
ܣܕܪܐ:ܡܢܝܢܐ	Catégorie:Nombre entier
ܣܕܪܐ:ܡܕܝܢܬܐ ܕܥܝܪܐܩ	Catégorie:Ville d'Irak
ܣܕܪܐ:ܥܝܢܐ (ܨܪܘܝܘܬܐ)	Catégorie:Œil
ܣܕܪܐ:ܓܘܪܓܝܐ	Catégorie:Géorgie
ܣܕܪܐ:ܟܘܘܝܬ	Catégorie:Koweït
ܣܕܪܐ:ܠܒܢܢ	Catégorie:Liban
ܣܕܪܐ:ܪܝܫܝ ܩܘܛܢܝܘܬܐ ܕܐܬܪܘܬܐ ܡܚܝܕܐ ܕܐܡܪܝܩܐ	Catégorie:Président des États-Unis
ܣܕܪܐ:ܝܘܪܕܢܢ	Catégorie:Jordanie
ܣܕܪܐ:ܦܐܪܐ	Catégorie:Fruit alimentaire
ܣܕܪܐ:ܓܒܐ	Catégorie:Parti politique
ܣܕܪܐ:ܕܝܬܝܩܝ ܚܕܬܐ	Catégorie:Nouveau Testament
ܣܕܪܐ:ܕܝܬܝܩܝ ܥܬܝܩܬܐ	Catégorie:Ancien Testament
ܣܕܪܐ:ܐܘܩܝܢܘ	Catégorie:Océan
ܣܕܪܐ:ܓܪܡܐ	Catégorie:Système squelettique
ܣܕܪܐ:ܗܘܦܪܟܝܣ ܘܐܘܚܕܢܐ ܕܩܢܕܐ	Catégorie:Province ou territoire canadien
ܣܕܪܐ:ܚܝܘܬܐ	Catégorie:Animal
ܣܕܪܐ:ܛܘܪܐ	Catégorie:Massif de montagne
ܣܕܪܐ:ܣܘܥܪܢܐ	Catégorie:Événement
ܣܕܪܐ:ܟܘܪܗܢܐ	Catégorie:Maladie
ܣܕܪܐ:User pl	Catégorie:Utilisateur pl
ܣܕܪܐ:ܩܣܪ	Catégorie:Empereur
ܣܕܪܐ:ܡܕܒܪܐ	Catégorie:Désert
ܣܕܪܐ:ܝܡܡܬܐ	Catégorie:Lac
ܩܠܒܐ:ܨܢܕܘܩ ܡܚܡܝܬܐ ܡܨܥܝܐ	Modèle:Infobox Média
ܩܠܒܐ:ܨܢܕܘܩ ܪܡܙܐ ܕܠܫܢܐ	Modèle:Infobox Langue
ܣܕܪܐ:ܩܛܠܥܡܐ	Catégorie:Massacre
ܨܝܢ	China
ܛܪܘܝܐܢܝ	Trojany (Mazovie)
ܩܠܒܐ:User tmr-1	Modèle:Utilisateur tmr-1
ܩܠܒܐ:User arc-2	Modèle:Utilisateur arc-2
ܩܠܒܐ:User arc-0	Modèle:Utilisateur arc-0
ܫܩܐ	Jambe
ܣܕܪܐ:ܦܛܪܝܪܟܘ ܕܥܕܬܐ ܕܡܕܢܚܐ ܕܐܬܘܪܝܐ	Catégorie:Patriarche apostolique assyrien de l'Orient
ܣܕܪܐ:ܦܛܪܝܪܟܘ ܕܥܕܬܐ ܟܠܕܝܬܐ ܩܬܘܠܝܩܝܬܐ	Catégorie:Patriarche catholique chaldéen de Babylone
ܩܠܒܐ:ܝܗܘܝܬܐ Falkland Islands	Modèle:Country data Îles Malouines
ܣܕܪܐ:ܦܛܪܝܪܟܘ	Catégorie:Patriarche
ط	Ṭāʾ
ܣܕܪܐ:ܒܝܬ ܟܬܒܐ	Catégorie:Bibliothèque
ܣܕܪܐ:ܒܝܬ ܢܗܪܝܢ	Catégorie:Mésopotamie
ܣܕܪܐ:ܕܝܪ̈ܬܐ ܣܘܪ̈ܝܝܬܐ	Catégorie:Monastère syriaque orthodoxe
ܣܕܪܐ:ܓܘܢܐ	Catégorie:Couleur
ܩܠܒܐ:ܝܗܘܝܬܐ South Georgia and the South Sandwich Islands	Modèle:Country data Géorgie du Sud-et-les Îles Sandwich du Sud
ܝܘܕ	Yōdh
ܣܕܪܐ:ܦܛܪܝܪܟܘ ܕܥܕܬܐ ܣܘܪܝܝܬܐ ܐܪܬܘܕܟܣܝܬܐ	Catégorie:Patriarche syriaque orthodoxe d'Antioche
ܣܕܪܐ:ܩܠܒܐ	Catégorie:Modèle par fonction
ܕܒܘܪܐ (ܪܚܫܐ)	Guêpe
ܣܕܪܐ:ܩܕܝܫܐ	Catégorie:Saint
ܩܪܕܐ (ܪܚܫܐ)	Tique
ܩܠܒܐ:ܣܝܩܘܡ ܫܘܪܝܐ	Modèle:Date début
ܩܠܒܐ:User nl-4	Modèle:Utilisateur nl-4
ܩܠܒܐ:User nl-3	Modèle:Utilisateur nl-3
ܩܠܒܐ:ܠܫܢܐ ܨܝܢܝܐ	Modèle:Palette Langue chinoise
ܬܪܥܐ:ܐܘܩܝܢܘܣܝܐ	Portail:Océanie
ܟܬܒܐ	Écriture littéraire
ܦܐܪܐ	Fruit
ܢܘܓܗܐ	Aube (temps)
ܕܝܠܢܝܐ:ܫܘܚܠܦ̈ܐ ܚܕ̈ܬܐ	Spécial:Modifications récentes
ܘܙܐ	Oie
ܟܦ	Kāph
ܚܝܬ	Ḥēth
ܥܐ	ʿĒ
ܬܘ	Taw
