Hĭ-ciŭ	Afrique
Nĭk-buōng	Japon
Nàng Mī-ciŭ	Amérique du Sud
Nò̤-ŭi	Norvège
Ĭng-gáik-làng	Angleterre
Sŭ-gáik-làng	Écosse
Ŭi-ī-sê̤ṳ	Pays de Galles
Báe̤k Ái-ī-làng	Irlande du Nord
Ái-ī-làng	Irlande (pays)
Hungary	Hongrie
Să̤-băng-ngà	Espagne
Mī-guók	États-Unis
Bī-lé-sì	Belgique
Luxembourg	Luxembourg (pays)
Ṳ̄-dêu	Univers
Dê-giù	Terre
Sĕng-mêng	Vie
Sī	Mort
Nè̤ng	Homo sapiens
Huăng-hī	Bonheur
George Washington	George Washington
Wikidata	Wikidata
Hŭng-làng	Finlande
Sôi-diēng	Suède
Dăng-măk	Danemark
Pŏ̤-làng	Pologne
Lithuania	Lituanie
É-dâi-lé	Italie
Sô̤i-sê̤ṳ	Suisse
Ó̤-dê-lé	Autriche
Hĭ-lé-nà̤	Grèce
Tū-ī-gì	Turquie
Bì-ciū	Bière
Può-dò̤-ngà	Portugal
Ĕu-ciŭ	Europe
Ā-ciŭ	Asie
Báe̤k Mī-ciŭ	Amérique du Nord
Nàng-gĭk-ciŭ	Antarctique
Wikipedia	Wikipédia
Hò̤-làng	Pays-Bas
Ĭng-gĕng	Pénis
PHP	PHP
Niū-iók-chê	New York
Washington, D.C.	Washington (district de Columbia)
Gô-gĭng-săng	San Francisco
Báik-lìng	Berlin
Los Angeles	Los Angeles
Diêng-nō̤	Ordinateur
Sŭ-là̤-sié	Zurich
Barack Obama	Barack Obama
Uruguay	Uruguay
MediaWiki	MediaWiki
Lùng-dŭng	Londres
Bìng-guō	Pomme
Bă-là̤	Paris
Mĕ̤k-să̤-gŏ̤	Mexique
Dâi-să̤-iòng	Océan Atlantique
Tái-bìng-iòng	Océan Pacifique
California	Californie
Boston	Boston
Lā̤-bái-ék	Lundi
Huōi-sĭng	Mars (planète)
Kenya	Kenya
Ethiopia	Éthiopie
Gŭng-ciō (nguòng-siū)	Monarque
Ghana	Ghana
Lā̤-bái-nê	Mardi
Lā̤-bái-săng	Mercredi
Lā̤-bái-sé	Jeudi
Lā̤-bái-ngô	Vendredi
Lā̤-bái-lĕ̤k	Samedi
Lā̤-bái-nĭk	Dimanche
Săi (mà-kuŏ dông-ŭk)	Lion
Huák-guók	France
Kēng	Chien
Ĭng-guók	Royaume-Uni
Mà	Chat
Dṳ̆ng-huà Ìng-mìng Gê̤ṳng-huò-guók	Chine
Huák-ngṳ̄	Français
Wiktionary	Wiktionnaire
Ngṳ̀	Poisson
Ciū	Boisson alcoolisée
Bă-să̤	Brésil
Ngò̤-lò̤-sṳ̆	Russie
Hāi	Mer
Alabama	Alabama
Wikimedia	Wikimedia Foundation
Jimmy Wales	Jimmy Wales
Dáik-guók	Allemagne
Belarus	Biélorussie
Dáik-ngṳ̄	Allemand
Bĭng-dō̤	Islande
Estonia	Estonie
Tū-sĭng	Saturne (planète)
Hĭ-gĭ	Avion
Ciéng-cĕng	Guerre
1	1 (nombre)
2	2 (nombre)
3	3 (nombre)
4	4 (nombre)
5	5 (nombre)
0	Zéro
George W. Bush	George W. Bush
Latvia	Lettonie
Ukraine	Ukraine
Ciék-káik	République tchèque
Slovakia	Slovaquie
Slovenia	Slovénie
Moldova	Moldavie
Romania	Roumanie
Bulgaria	Bulgarie
Lò̤-mā	Rome
Macedonia Gê̤ṳng-huò-guók	Macédoine (pays)
Albania	Albanie
Croatia	Croatie
Bosnia gâe̤ng Herzegovina	Bosnie-Herzégovine
Azerbaijan	Azerbaïdjan
Andorra	Andorre
Cyprus	Chypre (pays)
Georgia (guók-gă)	Géorgie (pays)
Kazakhstan	Kazakhstan
Malta	Malte
Monaco	Monaco
Montenegro	Monténégro
Vaticano	Vatican
San Marino	Saint-Marin
Gū-bă	Cuba
Belize	Belize
Barbados	Barbade
Java	Java (langage)
Éng-dô-nà̤-să̤-ā	Indonésie
Tū-ī-gì-ngṳ̄	Turc
Nàng-hĭ	Afrique du Sud
Algeria	Algérie
Wiki Dù-cṳ̆-guāng	Wikisource
Uzbekistan	Ouzbékistan
Huà-să	Varsovie
Può-dò̤-ciū	Vin
Cūi	Eau
Chà	Bois
Diêng-sê	Télévision
Chile	Chili
Ià-sŭ	Jésus-Christ
Galileo Galilei	Galilée (savant)
Cūi-sĭng	Mercure (planète)
Lĭk-sṳ̄	Histoire
Gĭng-sĭng	Vénus (planète)
Ngṳ̄-ngiòng	Langage
Ái	Amour
Mŭk-sĭng	Jupiter (planète)
Ngṳ̀ng-ò̤	Voie lactée
Tiĕng-uòng-sĭng	Uranus (planète)
Hāi-uòng-sĭng	Neptune (planète)
Tiĕng-ùng	Astronomie
Sĭng-gă-pŏ̤	Singapour
Kuŏ-hŏk	Science
Mìng-uòng-sĭng	Pluton (planète naine)
Ciŏng-lài	Futur
Séng-mū Mā-lé-ā	Marie (mère de Jésus)
Liechtenstein	Liechtenstein
Adolf Hitler	Adolf Hitler
Dâ̤-nê-ché̤ṳ Sié-gái Dâi-ciéng	Seconde Guerre mondiale
Wiki Gáu-kuŏ-cṳ̆	Wikibooks
Wiki Ngṳ̄-liŏh	Wikiquote
Wiki Dâi-hŏk	Wikiversité
Cṳ̆ng	Horloge
Ubuntu	Ubuntu
Linux	Linux
Só-hŏk	Mathématiques
Lá-dĭng-ngṳ̄	Latin
Bahrain	Bahreïn
Armenia	Arménie
Serbia	Serbie
Nguŏk-giù	Lune
Istanbul	Istanbul
Ó̤-ciŭ	Australie
Ŭk-lī	Physique
Argentina	Argentine
Peru	Pérou
Dièu-siēng Mìng-ciō-ciō-ngiê Ìng-mìng Gê̤ṳng-huò-guók	Corée du Nord
Gāng-puŏ-câi	Cambodge
Gū-làng-gĭng	Coran
Kṳ̄ng-lṳ̀ng	Dinosaure
Ĭ-sṳ̆-làng-gáu	Islam
Lì	Pyrus
Lùng-lùng	Roue
Huò-bìng	Paix
Nṳ̄-gái	Femme
Gū-chiŏng-kĕ̤ng	Anus
Nìng-mùng	Citron
Bă-ciĕu	Banane
Huă	Fleur
Napoléon Bonaparte	Napoléon Ier
Sĕng-lī	Physiologie
Hèng-sĭng	Étoile
Nĭk-tàu	Soleil
Victor Hugo	Victor Hugo
Dâi-iòng-ciŭ	Océanie
Tái-iòng-hiê	Système solaire
Ngāi	Dent
Kĭng	Hydrogène
Wiki Gê̤ṳng-hiōng	Wikimedia Commons
Cṳ̆	Livre (document)
Nĭk	Jour
Dĕ̤ng Timor	Timor oriental
Màng-buŏ	Nuit
Nièng	Année (calendrier)
Ó̤-sṳ̆-lṳ̆k	Oslo
Lī-sṳ̆-buōng	Lisbonne
Táng	Carbone
Dâng	Azote
Iōng	Oxygène
Giàng-sĭng	Planète
Kleopatra 7-sié	Cléopâtre VII
Ĭng-ngŏk	Musique
É-dâi-lé-ngṳ̄	Italien
Séng Peterburg	Saint-Pétersbourg
Chad	Tchad
Lé̤ṳ	Aluminium
Sĭng-să̤-làng	Nouvelle-Zélande
Éng-dô	Inde
Tuvalu	Tuvalu
Tiék	Fer
Tonga	Tonga
Samoa	Samoa
Solomon Gùng-dō̤	Salomon (pays)
Vanuatu	Vanuatu
Papua New Guinea	Papouasie-Nouvelle-Guinée
William Shakespeare	William Shakespeare
Palau	Palaos
Nauru	Nauru
Micronesia Lièng-băng	Micronésie (pays)
Iòng (gĭng-sṳ̆k)	Plomb
Marshall Gùng-dō̤	Îles Marshall
Kiribati	Kiribati
Mūng-gū	Mongolie
Fiji	Fidji
Venezuela	Venezuela
Guók-cié chiông-gì	Échecs
Genghis Khan	Gengis Khan
Maine	Maine (État)
Mā	Cheval
Ū-ké	Arme
Dông-ŭk	Animal
Suriname	Suriname
Paraguay	Paraguay
Guyana	Guyana
Ecuador	Équateur (pays)
Colombia	Colombie
Hŭk-gáu	Bouddhisme
Bolivia	Bolivie
Dè̤ng	Cuivre
Trinidad gâe̤ng Tobago	Trinité-et-Tobago
Sĭk-ŭk	Plante
Séng Vincent gâe̤ng Grenadines	Saint-Vincent-et-les-Grenadines
New Hampshire	New Hampshire
Séng Lucia	Sainte-Lucie
Séng Kitts gâe̤ng Nevis	Saint-Christophe-et-Niévès
Cĭng-kṳ̄ng	Fungi
Jamaica	Jamaïque
Grenada	Grenade (pays)
Massachusetts	Massachusetts
Guatemala	Guatemala
Bahamas	Bahamas
Connecticut	Connecticut
Giĕ	Gallus gallus domesticus
Antigua gâe̤ng Barbuda	Antigua-et-Barbuda
Hawaii	Hawaï
Honduras	Honduras
Dominica	Dominique (pays)
Dominica Gê̤ṳng-huò-guók	République dominicaine
Dṳ̆	Porc
Báe̤k-bĭng-iòng	Océan Arctique
Haiti	Haïti
El Salvador	Salvador
Ĭ-lāng	Iran
Iraq	Irak
Alaska	Alaska
Costa Rica	Costa Rica
Ī-sáik-liĕk	Israël
Panama	Panama
Yemen	Yémen
Bâng-dŭk	Virus
Pŏ̤-làng-ngṳ̄	Polonais
Jordan	Jordanie
Nicaragua	Nicaragua
Florida	Floride
Kyrgyzstan	Kirghizistan
Arizona	Arizona
Kuwait	Koweït
Lō̤-kuŏ	Laos
Lebanon	Liban
Oregon	Oregon
Maldives	Maldives
Mī-ciŭ	Amérique
Utah	Utah
Ngù	Bos taurus
Mā-lài-să̤-ā	Malaisie
Miēng-diêng	Birmanie
Nepal	Népal
Oman	Oman
Pakistan	Pakistan
Qatar	Qatar
Saudi Ā-lá-báik	Arabie saoudite
Sri Lanka	Sri Lanka
Joseph Stalin	Joseph Staline
Syria	Syrie
Platon	Platon
Tajikistan	Tadjikistan
Dṳ̆ng-huà Mìng-guók	Taïwan
Aristoteles	Aristote
Tái-guók	Thaïlande
Huōi-chiă	Train
Turkmenistan	Turkménistan
Ā-lá-báik Lièng-hăk Dâi-gŭng-guók	Émirats arabes unis
Băh-gĭng	Platine
Uŏk-nàng	Viêt Nam
Dâi-hàng Mìng-guók	Corée du Sud
Afghanistan	Afghanistan
Gĭng	Or
Suez Ông-ò̤	Canal de Suez
Bangladesh	Bangladesh
Mali	Mali
Sokrates	Socrate
Angola	Angola
Bhutan	Bhoutan
Ùng-lài	Brunei
Tanzania	Tanzanie
Cūi-ngṳ̀ng	Mercure (chimie)
Hĭ-lĭ-pĭng	Philippines
Dṳ̆ng-hĭ Gê̤ṳng-huò-guók	République centrafricaine
Isaac Newton	Isaac Newton
Albert Einstein	Albert Einstein
Uòng-sáik	Jaune
Togo	Togo
Tunisia	Tunisie
Zambia	Zambie
Zimbabwe	Zimbabwe
Báe̤k-gĭng	Pékin
Nàng Sudan	Soudan du Sud
Benin	Bénin
Botswana	Botswana
Wiki Sĭng-ùng	Wikinews
Burkina Faso	Burkina Faso
Burundi	Burundi
Comoros	Comores (pays)
Congo Gê̤ṳng-huò-guók	République du Congo
Congo Mìng-ciō Gê̤ṳng-huò-guók	République démocratique du Congo
Djibouti	Djibouti
Chiáh-dô̤ Guinea	Guinée équatoriale
Eritrea	Érythrée
Gabon	Gabon
Gambia	Gambie
Guinea	Guinée
Guinea-Bissau	Guinée-Bissau
Côte d'Ivoire	Côte d'Ivoire
Cameroon	Cameroun
Cabo Verde	Cap-Vert
Lesotho	Lesotho
Liberia	Liberia
Libya	Libye
Madagascar	Madagascar
Malawi	Malawi
Mauritania	Mauritanie
Mauritius	Maurice (pays)
Morocco	Maroc
Mozambique	Mozambique
Namibia	Namibie
Niger	Niger
Nigeria	Nigeria
Charles Darwin	Charles Darwin
Uganda	Ouganda
Rwanda	Rwanda
Séng Tomé gâe̤ng Príncipe	Sao Tomé-et-Principe
Senegal	Sénégal
Seychelles	Seychelles
Carl Linnaeus	Carl von Linné
Sierra Leone	Sierra Leone
Somalia	Somalie
Julius Caesar	Jules César
Sudan	Soudan
Swaziland	Swaziland
Kê̤ṳng	Arc-en-ciel
Lièng-hăk-guók	Organisation des Nations unies
Dê-cék	Géologie
Dê-lī	Géographie
Sĭng-câung	Cœur
Puòi-hŭ	Peau
Ngàng-sáik	Couleur
Làng-sáik	Bleu
Ngṳ̀ng	Argent
Sék	Étain
Michigan	Michigan
Illinois	Illinois
North Dakota	Dakota du Nord
South Dakota	Dakota du Sud
Montana	Montana
Wyoming	Wyoming
Idaho	Idaho
Washington	Washington (État)
Nevada	Nevada
Éng-dô-iòng	Océan Indien
Kosovo	Kosovo
Colorado	Colorado
分類:Hŭng-lôi	Catégorie:Accueil
Chicago	Chicago
Dĕ̤ng-tiĕng	Hiver
Chŭng-tiĕng	Printemps
Hâ-tiĕng	Été
Chiŭ-tiĕng	Automne
Saddam Hussein	Saddam Hussein
Osama bin Laden	Oussama ben Laden
Să̤-băng-ngà-ngṳ̄	Espagnol
Philadelphia	Philadelphie
Tĭ-tṳ̆	Araneae
Guō-sĭk	Fruit (botanique)
Gàu	Singe
Cièng	Monnaie
Virginia	Virginie (État)
West Virginia	Virginie-Occidentale
Huăng-ciĕu	Capsicum annuum
Niū-iók-ciŭ	État de New York
Rhode Island	Rhode Island
Kŏng-tṳ̀ng	Insecte
Maryland	Maryland
Delaware	Delaware
Vladimir Lenin	Vladimir Ilitch Lénine
Ohio	Ohio
Pennsylvania	Pennsylvanie
Augustus	Auguste
Microsoft Windows	Microsoft Windows
New Jersey	New Jersey
Hŭng-làng-ngṳ̄	Finnois
Indiana	Indiana
Ké-chiă	Automobile
Georgia	Géorgie (États-Unis)
Texas	Texas
North Carolina	Caroline du Nord
South Carolina	Caroline du Sud
Manila	Manille
Dĕ̤ng-gĭng	Tokyo
Uòng-lì	Ananas
Mississippi	Mississippi (État)
Tennessee	Tennessee
New Mexico	Nouveau-Mexique
Ngà-diēng	Athènes
Minnesota	Minnesota
Baghdad	Bagdad
Wisconsin	Wisconsin
Iowa	Iowa
Nebraska	Nebraska
Kansas	Kansas
Hŏng-giāng	Cigarette
Missouri	Missouri (État)
Louisiana	Louisiane
Kentucky	Kentucky
Arkansas	Arkansas
Oklahoma	Oklahoma
Madonna	Madonna
Aceh	Aceh
Séng-gĭng	Bible
Phnom Penh	Phnom Penh
Hù Cé-mìng Chê	Hô-Chi-Minh-Ville
Ò̤-nô̤i	Hanoï
Cĭng Ià-sŭ Gáu-huôi	Véritable Jésus Église
Ĭng-ngṳ̄	Anglais
Màng-gók	Bangkok
Kuala Lumpur	Kuala Lumpur
Bangka Belitung Gùng-dō̤	Îles Bangka Belitung
Dài-báe̤k	Taipei
Concepción	Concepción (Chili)
Bengkulu	Bengkulu (province)
Końskowola	Końskowola
Nê-iōng-huá-táng	Dioxyde de carbone
Jambi	Jambi (province)
Siè	Serpentes
Lampung	Lampung
Guŏng-sók	Vitesse de la lumière
Riau	Riau
Riau Gùng-dō̤	Îles Riau (province)
Nàng Sumatra	Sumatra du Sud
Lò̤-mā Dá̤-guók	Empire romain
Mì-niōng	Microsoft
Kó-lū-hŭ	Kurów
Huá-hŏk	Chimie
Sièng-sŏng	Acide chlorhydrique
Ôi-sĭng	Satellite naturel
Kă-giù	Football
Să̤ Sumatra	Sumatra occidental
Mā-dáik-lī	Madrid
Michael Jackson	Michael Jackson
Cê̤ṳ-iù	Liberté
Cṳ̆-niòng-giāng	Fille
Sék-nà̤	Sydney
Liŏh-sáik	Vert
È̤ng-sáik	Rouge
Huōi	Feu
Sĭng Nàng Wales	Nouvelle-Galles du Sud
Nile Ò̤	Nil
Banten	Banten (province)
Dṳ̆ng Jawa	Java central
Chēng-chiū-sĭng	Comète
Dĕ̤ng Jawa	Java oriental
Jakarta	Jakarta
Ăng-kā-lá	Ankara
Să̤ Jawa	Java occidental
Yogyakarta	Territoire spécial de Yogyakarta
Dṳ̆ng Kalimantan	Kalimantan central
Dĕ̤ng Kalimantan	Kalimantan oriental
Báe̤k Kalimantan	Kalimantan du Nord
Nàng Kalimantan	Kalimantan du Sud
Hŏk-hâu	École
Să̤ Kalimantan	Kalimantan occidental
Dâi-hŏk	Université
Wikipedia:Să-buàng	Wikipédia:Bac à sable
Chió	Maison
Dê-dù	Carte géographique
Ò̤	Rivière
Osasco	Osasco (Brésil)
Chiĕng-lī-giáng	Télescope
分類:Dài-uăng lĭk-sṳ̄	Catégorie:Histoire de Taïwan
Curitiba	Curitiba
Sĕng-lìng	Forêt
分類:Uŏk-nàng lĭk-sṳ̄	Catégorie:Histoire du Viêt Nam
Iók-báik-cṳ̆	Livre de Job
Cĭng-ngiòng	Livre des Proverbes
Kūng-cṳ̄	Confucius
Hà	Decapoda
分類:Só-hŏk	Catégorie:Mathématiques
Bali	Bali
Ĕu-nguòng	Euro
Mī-gĭng	Dollar américain
Dâi-lièu	Dynastie Liao
Hòng-ciŭ	Hangzhou
Gĭ-dók-gáu	Christianisme
Dĕ̤ng Nusa Tenggara	Nusa Tenggara oriental
Să̤ Nusa Tenggara	Nusa Tenggara occidental
Dṳ̆ng Sulawesi	Sulawesi central
Gĭng-guók	Dynastie Jin (1115-1234)
Gorontalo	Gorontalo
Báe̤k Sulawesi	Sulawesi du Nord
Dĕ̤ng-nàng Sulawesi	Sulawesi du Sud-Est
Nàng Sulawesi	Sulawesi du Sud
Să̤ Sulawesi	Sulawesi occidental
Seattle	Seattle
Dêu	Riz
Maluku	Moluques (province)
Báe̤k Maluku	Moluques du Nord
Papua	Papouasie (province indonésienne)
Să̤ Papua	Papouasie occidentale
Cēu	Oiseau
Siū-dŭ	Capitale
Può-dò̤-ngà-ngṳ̄	Portugais
Nguŏk	Mois
Uòng Hiêng-huàng	Huang Xianfan
Cōng	Diamant
Nĭk-buōng-ngṳ̄	Japonais
Báik-kuŏ-ciòng-cṳ̆	Encyclopédie
Tàu Hiĕk	Wikipédia:Accueil principal
模板:Ô-lī-kó̤	Modèle:Bon article
Saratov	Saratov
Làng-giù	Basket-ball
Olympic Ông-dông-huôi	Jeux olympiques
Diòng-gĕ̤ng	Yangzi Jiang
Che Guevara	Che Guevara
Mò̤ Dĕk-dŭng	Mao Zedong
Să̤-ăng	Xi'an
Lá-sák	Lhassa
Séng-gău	Rapport sexuel
Ĭng-dô̤	Vagin
Diék-hŏk	Philosophie
分類:Ché̤ṳk-káik chēng-dṳ̀	Catégorie:Wikipédia:Suppression immédiate demandée
Gáung-kìng	Piano
Dà	Thé
Marco Polo	Marco Polo
Hebe Camargo	Hebe Camargo
Gê̤ṳng-sāng-ciō-ngiê	Communisme
Cṳ̆-buōng-ciō-ngiê	Capitalisme
Guók-gă	Pays
Mìng-cŭk	Nation
Carthago	Carthage
Uōng-hiĕk liù-lāng-ké	Navigateur web
Siù-cūi	Natation
分類:Tiĕng-ùng	Catégorie:Astronomie
Hŭk	Bouddha
Lī Bĕk	Li Bai
Dù-cṳ̆-guāng	Bibliothèque
Sĕng-tái	Écologie
Céng-dê	Politique
Mìng-ciō	Démocratie
Cìng-dièu	Dynastie Qin
Nobel Ciōng	Prix Nobel
Cìng Sṳ̄-huòng	Qin Shi Huang
Dṳ̆ng-dĕ̤ng	Moyen-Orient
Háng-dièu	Dynastie Han
Làu Băng	Han Gaozu
Háng Ùng-dá̤	Han Wendi
Háng Gīng-dá̤	Han Jingdi
Háng Ū-dá̤	Han Wudi
Sĕng-ŭk	Organisme (physiologie)
Rabindranath Tagore	Rabindranath Tagore
Háng Guŏng-ū-dá̤	Han Guang Wudi
Gŭng-ciō-cié-dô	Monarchie
Siâ-huôi-ciō-ngiê	Socialisme
Cṳ̆ng-chói	Baiser
Nguòng-dièu	Dynastie Yuan
Háng Hióng-dá̤	Han Xiandi
Nazi Dáik-guók	Troisième Reich
Christopher Columbus	Christophe Colomb
Dâng Huò	Zheng He
Panama Ông-ò̤	Canal de Panama
Céng-dièu	Dynastie Jin (265-420)
Nàng-bĭng-iòng	Océan Austral
Uòng-ò̤	Fleuve Jaune
Sṳ̆-mā Ièng	Sima Yan
Ngê	Oreille
Pé	Nez
Mĕ̤k-ciŭ	Œil
Hŭng-muòng	Culicidae
Săi-ngṳ̀	Requin
Lŏk-dò̤	Camelus
Chiông	Éléphant
Mā-ngiê	Fourmi
Sùi-dièu	Dynastie Sui
Hò̤-làng-ngṳ̄	Néerlandais
Sùi Ùng-dá̤	Sui Wendi
Sùi Iòng-dá̤	Sui Yangdi
Să̤-hâ	Dynastie des Xia occidentaux
Sóng-dièu	Dynastie Song
Diêu Kuŏng-êng	Song Taizu
Sóng Tái-cŭng	Song Taizong
Sóng Cĭng-cŭng	Song Zhenzong
Sóng Ìng-cŭng	Song Renzong
Sóng Sìng-cŭng	Song Shenzong
Sóng Hŭi-cŭng	Song Huizong
Sóng Gŏ̤-cŭng	Song Gaozong
Sóng Lī-cŭng	Song Lizong
Sóng Duăng-cŭng	Song Duanzong
Ögedei	Ögödei
Güyük	Güyük
Möngke	Möngke
Kublai	Kubilai Khan
Huă-chái	Chou-fleur
Giò (sĭk-ŭk)	Aubergine
Siók	Neige
Niè-giāng	Enfant
Cā-tàu	Matin
Hŭng-cṳ̆ng	Minute (temps)
Ngò̤-lò̤-sṳ̆-ngṳ̄	Russe
Huák-lŭk	Droit
Hièng-huák	Constitution
Háng-ngṳ̄	Langues chinoises
Sá̤-bàu	Cellule (biologie)
Háik	Sang
Hié (ké-guăng)	Poumon
Romania-ngṳ̄	Roumain
Bulgaria-ngṳ̄	Bulgare
Ṳ̄	Pluie
Dê-cīng	Séisme
Cūi-căi	Inondation
Hāi-lâung	Tsunami
Hùng	Nuage
Hŭng-tăi	Cyclone tropical
Hŭng	Vent
Georgia-ngṳ̄	Géorgien
Háng-cê	Caractères chinois
Dièu-siēng-cê	Hangeul
Lá-dĭng cê-mō̤	Alphabet latin
Ùng-hŏk	Littérature
分類:Ĭng-ngŏk	Catégorie:Musique
分類:Ùng-hŏk	Catégorie:Littérature
È̤ng-làu-máe̤ng	Le Rêve dans le pavillon rouge
Hù-lì	Renard
Harry Potter	Harry Potter
Chiū-ìng	Masturbation
Siâ-huôi	Société (sciences sociales)
Gáu-ṳ̆k	Éducation
Nàng-gái	Homme
Ìng-guòng	Droits de l'homme
Temür	Témur Khan
Gŭng-sê̤ṳ	Armée
Gă-pĭ	Café
Săng	Montagne
Khayisan	Külüg Khan
Sŏng Dṳ̆ng-săng	Sun Yat-sen
Hiŏng-gē̤ng	Hong Kong
Miami	Miami
Hàng Ciéng	Guerre de Corée
Rinchinbal	Ningzong
Toghon Temür	Togoontomor
Siū-ék	Séoul
Siông-hāi	Shanghai
Ùng-huá Dâi-gáik-mêng	Révolution culturelle
Chĭng-dièu	Dynastie Qing
Uŏk-nàng Ciéng-cĕng	Guerre du Viêt Nam
Thomas Edison	Thomas Edison
Armenia-ngṳ̄	Arménien
Ukraine-ngṳ̄	Ukrainien
HTML	Hypertext Markup Language
Steven Spielberg	Steven Spielberg
Mŏ̤h-ngiòng	Mo Yan
Sôi-diēng-ngṳ̄	Suédois
Dăng-măk-ngṳ̄	Danois
Nò̤-ŭi-ngṳ̄	Norvégien
Luxembourg-ngṳ̄	Luxembourgeois
Ciék-káik-ngṳ̄	Tchèque
Karl Marx	Karl Marx
Nĕng-nĕng	Sein
Guŏng	Lumière
Hĭ-lé-nà̤-ngṳ̄	Grec
Ái-ī-làng-ngṳ̄	Irlandais
Kié-ngò̤	Manchot
Pŏ̤-sṳ̆-ngṳ̄	Persan
Cŭng-gáu	Religion
Hàng-guók-ngṳ̄	Coréen
Cháung-sié-gé	Livre de la Genèse
Chók-Ăi-gĭk-gé	Livre de l'Exode
Háng-ngṳ̄ Guăng-uâ	Mandarin (langue)
Uŏk-nàng-ngṳ̄	Vietnamien
Sigmund Freud	Sigmund Freud
Tái-guók-ngṳ̄	Thaï
Mā-lài-ngṳ̄	Malais (langue)
Mūng-gū-ngṳ̄	Mongol
Bandar Seri Begawan	Bandar Seri Begawan
Hĭ-báik-lài-ngṳ̄	Hébreu
Ŭi-ī-sê̤ṳ-ngṳ̄	Gallois
Sŭ-gáik-làng-ngṳ̄	Gaélique écossais
Vientiane	Vientiane
Lō̤-cṳ̄	Lao Tseu
Găng-câung	Foie
Sṳ̆-mā Chiĕng	Sima Qian
Tó	Lapin
Ciŏ Hĭ	Zhu Xi
Cìng-gāng	Émotion
Dâi-iòng	Océan
Victoria Nṳ̄-uòng	Victoria (reine)
Sék-giă-mèu-nà̤	Siddhartha Gautama
Mŭk-hâng-mĕk-dáik	Mahomet
Hŭ-ngék	Haleine
Ṳ̀-gă	Confucianisme
Bók-lō̤	Abdomen
Dô̤-gáu	Taoïsme
Chói-siĕk	Langue (anatomie humaine)
Dâiu-gáuk	Cou
Chói	Bouche
Elizabeth 2-sié	Élisabeth II
Dòng-dièu	Dynastie Tang
Dòng Gŏ̤-cū	Tang Gaozu
Dòng Tái-cŭng	Tang Taizong
Dòng Gŏ̤-cŭng	Tang Gaozong
Dòng Dṳ̆ng-cŭng	Tang Zhongzong
Dòng Iô-cŭng	Tang Ruizong
Ū Cáik-tiĕng	Wu Zetian
Dòng Hièng-cŭng	Tang Xuanzong
Dòng Sé̤ṳk-cŭng	Tang Suzong
Dòng Dâi-cŭng	Tang Daizong
Dòng Dáik-cŭng	Tang Dezong
Cê-mō̤	Lettre (alphabet)
Mìng-dièu	Dynastie Ming
Ciŏ Nguòng-ciŏng	Ming Hongwu
Ronald Reagan	Ronald Reagan
Gióng-ùng Huòng-dá̤	Ming Jianwen
Īng-lŏk Huòng-dá̤	Ming Yongle
Hùng-hĭ Huòng-dá̤	Ming Renzong
Sŏng-dáik Huòng-dá̤	Ming Xuanzong
Mìng Ĭng-cŭng	Ming Yingzong
Gīng-tái Huòng-dá̤	Ming Daizong
Sìng-huá Huòng-dá̤	Ming Xianzong
Hùng-dé Huòng-dá̤	Ming Hongzhi
Céng-dáik Huòng-dá̤	Ming Zhengde
Gă-cêng Huòng-dá̤	Ming Jiajing
Lè̤ng-kéng Huòng-dá̤	Ming Longqing
Uâng-lĭk Huòng-dá̤	Ming Wanli
Tái-chiŏng Huòng-dá̤	Ming Taichang
Tiĕng-kiē Huòng-dá̤	Ming Tianqi
Sùng-dĭng Huòng-dá̤	Ming Chongzhen
Gĭng Céng-nĭk	Kim Jong-il
Nguòng-só ciŭ-gĭ-biēu	Tableau périodique des éléments
Chăng-màng	Cécité
Sá̤-kṳ̄ng	Bacteria
Chéu	Arbre
Può-dò̤	Raisin
Huăng-giāng-sṳ̀	Pomme de terre
Tòng	Sucre
Uòng-dâu	Soja
Séng-sék	Information
Bó̤-cāi	Journal
Diêng-uâ	Téléphone
Ùng-huá	Culture
Huáng-ngṳ̄	Sanskrit
Dâi-diòng	Gros intestin
Siēu-diòng	Intestin grêle
Ĭ-hŏk	Médecine
Sièng	Sel alimentaire
Huá-hŏk nguòng-só	Élément chimique
Unix	Unix
Ùi-gì	Jeu de go
Káh-dièu-nó̤h	Jouet
Gĭng-sṳ̆k	Métal
Kă-dăk-chiă	Bicyclette
Mièng-huă	Coton
Sì-găng	Temps
Cāi	Papier
Só-lâiu	Matière plastique
Miêng-cék	Aire (géométrie)
Gŭng-chióh	Mètre
Iù-diĕng-bău	Maïs
Duâi-măk	Orge commune
Dĕ̤ng-nàng-ā	Asie du Sud-Est
Sīng-iòng	Shenyang
Tṳ̀ng-kéng	Chongqing
Tiĕng-cĭng	Tianjin
Ū-háng	Wuhan
Gū Ăi-gĭk	Égypte antique
Gū Hĭ-lé-nà̤	Grèce antique
Hṳ̀ng	Ursidae
Britney Spears	Britney Spears
Ngàng	Cancer
Măk	Blé
Cié-sē̤	Sorghum
Pó̤-sióng	Handicap
Lĭk-huák	Calendrier
Sìng-gĭng-bâng	Trouble psychique
Gregorius Lĭk-huák	Calendrier grégorien
Tutankhamun	Toutânkhamon
Nguŏk-gĭng	Menstruation
Mà-chiók	Mah-jong
Ông-ò̤	Canal (voie d'eau)
Detroit	Détroit (Michigan)
Diòng-siàng	Grande Muraille
Gĭng-cê-ták	Pyramide (architecture)
Osman Dá̤-guók	Empire ottoman
Guók-nô̤i sĕng-sāng cūng-dĭk	Produit intérieur brut
Diêng	Électricité
Ché̤ṳng	Arme à feu
Lòng-gĭ-ché̤ṳng	Mitrailleuse
Sáung-buàng	Boulier
Tāng-káik	Char de combat
Chāu-muòi	Fragaria ×ananassa
Liĕk-chiĕ	Litchi
Ià-cī	Cocos nucifera
Tò̤	Pêcher
Cáung-ngṳ̄	Zhuang (langue)
Siŏng-ngṳ̄	Xiang
Mì-ngù-ī-ngṳ̄	Ouïghour
Lâung-gŏ̤	Gâteau
Wiki Ŭk-cṳ̄ng	Wikispecies
Nĕng-dáe̤k	Soutien-gorge
Ā-lá-báik-ngṳ̄	Arabe
Cūng-lī	Premier ministre
Dièu-siēng Tái-cŭng	Taejong
Lù Ū-hièng	Roh Moo-hyun
Páuk Céng-hĭ	Park Chung-hee
Siĕng-ìng-ciōng	Cactaceae
Siŏh-tàu-lâung	Galet
Iòng-bék	Crayon
Gă-sĭ	Meuble
Dó̤h	Table
Ó̤-muòng	Macao
Liòng Cīng-ĭng	Leung Chun-ying
Iē-giāng	Chaise
Hù Gīng-dò̤	Hu Jintao
Sĭk Gê̤ṳng-bìng	Xi Jinping
Dòng-gêng-lĕ̤k	Girafe
Chĭng-dáung	Shenzhen
Guōng-dĕ̤ng	Guangdong
Guōng-să̤	Guangxi
Sŭ-lièng	Union des républiques socialistes soviétiques
Kiák-sióng-gĭ	Appareil photographique
Kagoshima-gâing	Préfecture de Kagoshima
C ngṳ̄-ngiòng	C (langage)
Kă	Pied (anatomie humaine)
Ciēng	Gekkonidae
Dô-dâing	Lacertilia
Giĕng-tàu	Épaule
Wikipedia:Bō̤-ciéng hō̤ ùng	Wikipédia:Articles de qualité
Sié-gái	Monde (univers)
Wikipedia:Duâi chéu â	Wikipédia:Le Bistro
Busan	Busan
Lèng-huă	Nelumbo nucifera
Vermont	Vermont
Denver	Denver
Guōng-ciŭ	Canton (Chine)
Ciōng Gái-sĭk	Tchang Kaï-chek
Gŏng Dĕk-mìng	Jiang Zemin
Ŭng Gă-bō̤	Wen Jiabao
Nàng-gĭng	Nankin
Làu Dáik-huà	Andy Lau
Diŏng Hŏk-iū	Jacky Cheung
Báe̤k-gĭng Dâi-hŏk	Université de Pékin
Chĭng-huà Dâi-hŏk	Université Tsinghua
Ŭ-lū-mŭk-cà̤	Ürümqi
Gŏng-sŭ	Jiangsu
Ciék-gŏng	Zhejiang
Dâing Siēu-bìng	Deng Xiaoping
Lò̤-mā Gê̤ṳng-huò-guók	République romaine
Câung-kṳ̆	Tibet
Să̤-câung	Région autonome du Tibet
Ciŭ Ŏng-lài	Zhou Enlai
Dṳ̆ng-guók Gê̤ṳng-sāng-dōng	Parti communiste chinois
Chiū-gĭ	Téléphone mobile
Dò̤-nēu	Autruche d'Afrique
Kŏng-hĭ Huòng-dá̤	Kangxi
Dièu-siēng	Corée
Lī Káik-giòng	Li Keqiang
Gŏ̤ Hèng-giông	Gao Xingjian
Ciŏ Ṳ̀ng-gĭ	Zhu Rongji
Lī Bèng	Li Peng
Lòng	Canis lupus
Bìng-iōng	Pyongyang
Sĭng-iók Séng-gĭng	Nouveau Testament
9	9 (nombre)
Kiék	Scorpiones
Gièng-lè̤ng Huòng-dá̤	Qianlong
Dṳ̆ng-guók Dâi-lṳ̆k	Chine continentale
Háik-lṳ̀ng-gĕ̤ng-sēng	Heilongjiang
Mā Ĭng-gāu	Ma Ying-jeou
Lè̤	Âne commun
Wikipedia:Cék-liông ô-lī-kó̤ gì ùng-ciŏng	Wikipédia:Bons contenus
Sé-chiŏng	Sichuan
Gô-iók Séng-gĭng	Ancien Testament
Séng-dáng-cáik	Noël
Săng-gáe̤k-hìng	Triangle
Muammar Gaddafi	Mouammar Kadhafi
Lâu-hū	Tigre
Daejeon	Daejeon
Daegu	Daegu
Sié-cŭng Dĕk-biék Cê̤ṳ-dé-chê	Sejong (ville)
Incheon	Incheon
Gyeonggi Dô̤	Gyeonggi
Bô-uăk-cáik	Pâques
Ò̤-báe̤k	Hebei
Bŏk Hĭ-lài	Bo Xilai
GNU Cê̤ṳ-iù Ùng-dáung Hṳ̄-kō̤-céng	Licence de documentation libre GNU
Uŏng Cĭng-ôi	Wang Jingwei
Dìng Cūi-biēng	Chen Shui-bian
Dài-uăng	Taïwan (île)
À̤	Chaussure
Ngṳ̀ng-hòng	Banque
Lū Séng	Lu Xun (écrivain)
7	7 (nombre)
8	8 (nombre)
Lĕ̤k	Cervidae
Hù	Lac
Sáung-tàu	Ail cultivé
Chái-guă	Concombre
Dō̤	Île
Băh-sáik	Blanc
Ŭ-sáik	Noir
6	6 (nombre)
Moshchena	Mochtchena
Huăng-kê	Tomate
George H. W. Bush	George H. W. Bush
Paltoga	Paltoga
Quảng Bình	Province de Quảng Bình
Atlanta	Atlanta
Benito Mussolini	Benito Mussolini
Sṳ̀-diēng	Dictionnaire
Tàu	Tête (anatomie)
Hiê-lìng-dóng	Wellington
Dâi Bók-liĕk-diĕng Dō̤	Grande-Bretagne
Las Vegas	Las Vegas
10	10 (nombre)
Alfred Nobel	Alfred Nobel
Tàu-sĕ̤	Peigne
Guòng-lĭk	Pouvoir (sociologie)
Mà-hùng-cēu	Strigiformes
Dēng-cṳ̆ng	Heure
Ké-chiông	Météorologie
Đà Nẵng	Đà Nẵng
Káh-chiók	Pie bavarde
Làng-huă	Orchidaceae
Gă-săk	Blattaria
Ngáuk-ngṳ̀	Crocodilia
Lā-lì	Pangolin
Nàng-muōi-sĭng	Lampyridae
Holocene	Holocène
Hāi-báu	Phocidae
Bà̤-bá-cēu	Troglodyte mignon
Ciáh-giāng	Moineau friquet
Niccolò Cusano Dâi-hŏk	Université Nicolas-de-Cues
Long An	Province de Long An
Thái Nguyên	Province de Thái Nguyên
Herodotus	Hérodote
Othello	Othello ou le Maure de Venise
Nĭk-buōng-hāi	Mer du Japon
Dĕ̤ng-ā	Asie de l'Est
Dĕ̤ng-ĕu	Europe de l'Est
Vĩnh Phúc	Province de Vĩnh Phúc
Chĕ̤ng	Ciboule
Liù-giù-guók	Royaume de Ryūkyū
Dièu-siēng uòng-dièu	Période Joseon
Gŏ̤-là̤	Goryeo
Dâi-hàng Dá̤-guók	Empire coréen
Buŏk-hāi-guók	Balhae
Gŏ̤-gău-là̤	Koguryo
Bì-bà-dâu-giék	Chiroptera
Báik-cá̤	Baekje
Sĭng-lò̤	Silla (Corée)
Tàu-huók	Poil
Hàng Hĭ	Han Fei Zi
Uòng-dá̤	Huángdì
Diéu-ngṳ̀-dài Liĕk-dō̤	Îles Senkaku
Gê̤ṳng-huò-dōng (Mī-guók)	Parti républicain (États-Unis)
Dṳ̆ng-guók	Monde chinois
Mìng-ciō-dōng (Mī-guók)	Parti démocrate (États-Unis)
Cūi-tiák	Loutre d'Europe
Sìng-dŭ	Chengdu
Buò-gŭng-ĭng	Taraxacum
Tá	Méduse (animal)
Dâng-ciŭ	Zhengzhou
Cūng-tūng	Président
Muāng-ciŭ-guók	Mandchoukouo
Gù-cŭi	Streptopelia
Só̤h	Corde (outil)
Dṳ̆ng-guók Guók-mìng-dōng	Kuomintang
Hiăng-diê ciā-muói	Fratrie
Ngâng	Oie cygnoïde
Ĕng-gŏ̤	Psittaciformes
Gă-huák	Addition
Dài-uăng-sēng	Province de Taïwan
Dŏ̤	Couteau
Băng-mā	Zèbre
Guók-cié biĕu-cūng cṳ̆-hô̤	International Standard Book Number
Đồng Nai	Province de Đồng Nai
Sóc Trăng	Province de Sóc Trăng
Quảng Ngãi	Province de Quảng Ngãi
Hà Tĩnh	Province de Hà Tĩnh
Cà Mau	Province de Cà Mau
Quảng Nam	Province de Quảng Nam
Bến Tre	Province de Bến Tre
Khánh Hòa	Province de Khánh Hòa
Káh-gă-ngṳ̄	Hakka (langue)
Sơn La	Province de Sơn La
Huŏng-ngiòng	Dialecte
Lev Trotsky	Léon Trotski
Quảng Ninh	Province de Quảng Ninh
Lạng Sơn	Province de Lạng Sơn
Bắc Ninh	Province de Bắc Ninh
Gáng-ngṳ̄	Gan (langue)
Sṳ̆-mā Guŏng	Sima Guang
Mà-hṳ̀ng	Panda géant
Muāng-ngṳ̄	Mandchou
Chiū	Main
Dô Hū	Du Fu
Gùng-dō̤	Archipel
Niŏh-niŏh	Feuille
Bŭk-buó	Chute d'eau
Yasser Arafat	Yasser Arafat
Chṳ̆ng-sìng-ngṳ̄	Okinawaïen
Câung-ngṳ̄	Tibétain
Ngù-ngṳ̄	Wu (langue)
Tasmania	Tasmanie
Ì-cô̤	Savon
Hŭk-săng	Foshan
Ciĕu-huò Tiĕng-huòng	Hirohito
Al-Qaeda	Al-Qaïda
Mò̤-táuk-chiă	Motocyclette
Ò̤-mā	Hippopotamus amphibius
Anastacia	Anastacia
Sĕk Gái	Décalogue
Huă-báu	Léopard
Să̤-ngiù	Rhinocéros
Lò̤-buàng	Boussole
Buáng-dō̤	Péninsule
Sĭng-giŏng	Xinjiang
Mŭk-guă	Papayer
Mì-sĕng-só	Vitamine
Gái-làng-chái	Chou cabus
Giáng	Miroir
Ciŭ-dièu	Dynastie Zhou
Kāng-muòng-giāng	Fenêtre
Băh Gṳ̆ng	Maison-Blanche
Gīng-chák	Police (institution)
Báe̤k-hāi-dô̤	Hokkaidō
Giŏng	Gingembre
Nobel Huò-bìng Ciōng	Prix Nobel de la paix
Sáu	Toux
Hák-chê	Éternuement
Káung-mìng	Sommeil
Gèng-hāi	Mer d'Aral
Dé̤ṳk	Bambou
Hù Cé-mìng	Hô Chi Minh
Hòa Bình	Province de Hòa Bình
Sŭ Sék	Su Shi
Queensland	Queensland
Tù	Sol (pédologie)
Ù-huă-guō	Ficus carica
Hưng Yên	Province de Hưng Yên
Dòng-dô	Longueur
Kon Tum	Province de Kon Tum
Hậu Giang	Province de Hậu Giang
Máe̤ng	Rêve
Yên Bái	Province de Yên Bái
Bắc Giang	Province de Bắc Giang
Thừa Thiên-Huế	Province de Thừa Thiên-Huế
Bắc Kạn	Province de Bắc Kạn
Lai Châu	Province de Lai Châu
Hà Nam	Province de Hà Nam
Lào Cai	Province de Lào Cai
Mìng-dĕ̤ng-ngṳ̄	Mindong
Hannibal	Hannibal Barca
Mìng-báe̤k-ngṳ̄	Minbei
Mìng-nàng-ngṳ̄	Minnan
Thanh Hóa	Province de Thanh Hóa
Kiên Giang	Province de Kiên Giang
Quảng Trị	Province de Quảng Trị
Nghệ An	Province de Nghệ An
An Giang	Province d'An Giang
Tây Ninh	Province de Tây Ninh
Phú Thọ	Province de Phú Thọ
Duâi-sĭng-sĭng	Gorille
Trà Vinh	Province de Trà Vinh
Bạc Liêu	Province de Bạc Liêu
Gia Lai	Province de Gia Lai
Tiền Giang	Province de Tiền Giang
Bình Phước	Province de Bình Phước
Đồng Tháp	Province de Đồng Tháp
Thái Bình	Province de Thái Bình
Hà Giang	Province de Hà Giang
Đắk Lắk	Province de Đắk Lắk
Cáung-cŭk	Zhuang (ethnie)
Bình Định	Province de Bình Định
Lâm Đồng	Province de Lâm Đồng
Đắk Nông	Province de Đắk Nông
Phú Yên	Province de Phú Yên
Hải Dương	Province de Hải Dương
Dièu-ciŭ-uâ	Teochew (dialecte)
Iók-hâng Hók Ĭng	Évangile selon Jean
Dài-uăng-uâ	Taïwanais
Muòng	Porte (architecture)
Chiēng-gák	Ongle
Cao Bằng	Province de Cao Bằng
Bình Dương	Province de Bình Dương
Bình Thuận	Province de Bình Thuận
Bà Rịa-Vũng Tàu	Province de Bà Rịa-Vũng Tàu
Ninh Bình	Province de Ninh Bình
Ninh Thuận	Province de Ninh Thuận
Nam Định	Province de Nam Định
Điện Biên	Province de Điện Biên
Sìng-lṳ̀ng	Jackie Chan
Méng	Visage
Ùng-ngiòng-ùng	Chinois classique
Gāng-lāng	Olivier
Săng-ôi-ék-tā̤	Trinité (christianisme)
Sŏng-cṳ̄	Sun Tzu
Sĭng-săng	Instituteur
Cleveland	Cleveland
Dăk-lâi Lā-mà	Dalaï-lama
Huă-sĕng	Arachide
100	100 (nombre)
Kă-kók-tàu	Genou
Hâing	Abricotier
Ngāng-giáng	Lunettes
Cê̤ṳ-lài-huōi	Allumette
Chê-diòng	Marché
Nàng Dṳ̆ng-guók Hāi	Mer de Chine méridionale
Dièu-siēng Sié-cŭng	Sejong le Grand
Hăk-gĭng	Alliage
Bĭng-siŏng	Réfrigérateur
Nobel Ùng-hŏk Ciōng	Prix Nobel de littérature
Huăng-sṳ̀	Patate douce
Uòng-hāi	Mer Jaune
Akihito	Akihito
Newton ông-dông-hŏk dêng-lŭk	Lois du mouvement de Newton
Să̤-guă	Pastèque
Biobío Dâi-hŏk	Université du Bío-Bío
Huòng-dá̤	Empereur
Ìng-mìng-bê	Yuan
Tā̤-cék	Volume
Cèng-sáik	Orange (couleur)
Gă-sĭ-huă	Outil
Ĭ-sĕng	Médecin
Iéng (cēu)	Hirundinidae
Kó	Pantalon
Lô-gă Hók Ĭng	Évangile selon Luc
Mìng-ciō-dōng	Parti démocrate
Ciŏng-tàu	Brique (matériau)
Tiō-uòng	Ellipse (mathématiques)
Sìng-huák	Multiplication
Sé̤ṳ-dù Hèng-diông	Actes des Apôtres
Uòng-dô̤ Sĕk-nê Sĭng-cô̤	Zodiaque
Huá-siŏh	Fossile
Gēng-huák	Soustraction
Cī-cī	Graine
Chiĕk	Brachyura
Gă-dŏ̤	Paire de ciseaux
Niêu	Urine
Ăng-hŭi	Anhui
Ngiăh	Front (anatomie)
Sĭ-piĕng	Livre des Psaumes
Chungcheong Báe̤k-dô̤	Chungcheong du Nord
Chungcheong Nàng-dô̤	Chungcheong du Sud
Gangwon Dô̤ (Dâi-hàng Mìng-guók)	Gangwon
Nô̤i Mūng-gū	Mongolie-Intérieure
Gĭng Nĭk-sìng	Kim Il-sung
Gyeongsang Nàng-dô̤	Gyeongsang du Sud
Gyeongsang Báe̤k-dô̤	Gyeongsang du Nord
Jeolla Báe̤k-dô̤	Jeolla du Nord
Jeolla Nàng-dô̤	Jeolla du Sud
Jeju Dĕk-biék Cê̤ṳ-dé-dô̤	Jeju-do
Huăng-cièng-giāng	Pièce de monnaie
Bă-biĕk-ták	Tour de Babel
Ulsan	Ulsan
Gwangju	Gwangju
Chó	Vinaigre
Kangwŏn Dô̤ (Dièu-siēng Mìng-ciō-ciō-ngiê Ìng-mìng Gê̤ṳng-huò-guók)	Kangwon
Michael Jordan	Michael Jordan
Lé-ê-gé	Lévitique
Gṳ̆ng-gṳ̆ng	Racine (botanique)
Bì-bà (cūi-guō)	Eriobotrya japonica
Hamlet	Hamlet
Huà Guók-hŭng	Hua Guofeng
Sāng	Parapluie
Làu Hiēu-pŏ̤	Liu Xiaobo
Hók-gióng	Fujian
Mūng-gū-cŭk	Mongols
Mĕk-sê Liŏh	Apocalypse
Hièng-câung	Xuanzang
Gū-chiŏng	Fesse
Mìng-chòng	Lit (mobilier)
Hāi-nàng	Haïnan
Háng-ngṳ̄ Pĭng-ĭng	Hanyu pinyin
Uōng-dĕ̤ng	Extrême-Orient
Băh-gák	Pigeon biset
Găng-sé̤ṳk	Gansu
Taliban	Taliban
Huŏi-sáik	Gris
Sĭng-mêng-gé	Deutéronome
Sŭ-ciŭ	Suzhou
Ŭng-ciŭ	Wenzhou
Háng-cŭk	Han (ethnie)
Nìng-pŏ̤	Ningbo
Chói-chiŭ	Barbe
Cāi-iêu	Cerf-volant
Hăk-ī-bĭng	Harbin
Mā-kì	Hirudinea
1000	1 000 (nombre)
Mìng-só-gé	Livre des Nombres
Cáu-sèng	Cuisine (pièce)
Hùng-nàng	Yunnan
Lō̤-uă	Corvus
Săng-dĕ̤ng	Shandong
È̤ng-ĕ̤ng	Chilopoda
Ò̤-nàng	Henan
Mì-mò̤	Sourcil
Bók-sài	Nombril
Lièu-nìng	Liaoning
Hióng-liông	Vecteur euclidien
Cretaceous	Crétacé
Tochigi-gâing	Préfecture de Tochigi
Chói-mò̤-cēu	Alcedinidae
Dàu	Dé
Cūi-nà̤	Ciment
Gék-lìng	Jilin
Dĕ̤ng Dṳ̆ng-guók Hāi	Mer de Chine orientale
Hāi-chĕk	Piraterie
Gūi	Fantôme
Bóng-dó̤	Déchet
Hù-nàng	Hunan
Jurassic	Jurassique
Chĭng-hāi	Qinghai
Mì-ngù-ī-cŭk	Ouïghours
Ă-piéng	Opium
Chiū-cī	Bague
Hù-báe̤k	Hubei
Săng-să̤	Shanxi
Cĕ̤ng-sáik	Brun (couleur)
Giòng-găng	Viol
Gói-ciŭ	Guizhou
Triassic	Trias
Sék-sáuk	Gryllidae
Cāi-piéu	Billet de banque
SQL	Structured Query Language
Hù Sék	Hu Shi
Iók-cṳ̆-ā-gé	Livre de Josué
Cŏng-cṳ̄	Tchouang-tseu
Cṳ̀-hĭ Tái-hâiu	Cixi
Kan Naoto	Naoto Kan
Miyagi-gâing	Préfecture de Miyagi
模板:Commons category	Modèle:Commonscat
Lò̤-mā Cṳ̆	Épître aux Romains
Pău-ŭk-siáng	Parabole
Dô̤-dáik	Morale
Iwate-gâing	Préfecture d'Iwate
Ĭ-siòng-chiă	Machine à coudre
Dièu-siēng Lò̤-dông-dōng	Parti du travail de Corée
Nàng-báe̤k-dièu	Dynasties du Nord et du Sud
Chái Ĭ-lìng	Jolin Tsai
Pì-lĭk-bī Cṳ̆	Épître aux Philippiens
Ngā-gŏ-cṳ̆	Cantique des Cantiques
Mā-lăk-gĭ-cṳ̆	Livre de Malachie
模板:Taxobox	Modèle:Taxobox
分類:Guók-uòng	Catégorie:Roi
分類:Gŭng-ciō	Catégorie:Monarque
Diŏng Ngiê-mèu	Zhang Yimou
模板:Dṳ̆ng-guók lĭk-sṳ̄	Modèle:Palette Histoire de la Chine
Gĭng Céng-ŏng	Kim Jong-un
Liù-giù-ngṳ̄	Langues ryūkyū
Mìng-dṳ̆ng-ngṳ̄	Minzhong
Céng-ngṳ̄	Jinyu
Mìng-ngṳ̄	Min (langue)
Buò-siĕng-ngṳ̄	Puxian
Dài-uăng Mìng-nàng-ngṳ̄ Lò̤-mā-cê Pĭng-ĭng Huŏng-áng	Système de romanisation taïwanais
Gŏng-să̤	Jiangxi
Nìng-hâ	Ningxia
Lùng-sùng	Bateau-dragon (pirogue)
Noda Yoshihiko	Yoshihiko Noda
Yingluck Shinawatra	Yingluck Shinawatra
Siŏh-gă-cŏng	Shijiazhuang
Chṳ̄	Muroidea
Ciŏ-hāi	Zhuhai
Sáng-tàu	Shantou
Dâng-gŏng	Zhanjiang
Mùi-ciŭ	Meizhou
Chĭng-uōng	Qingyuan
Dĕ̤ng-uāng	Dongguan
Dṳ̆ng-săng-chê	Zhongshan
Dièu-ciŭ	Chaozhou
Tàng-táik	Siluriformes
Gé̤ṳk-huă	Chrysanthemum
Mĕ̤k-lê-huă-dà	Thé au jasmin
Sofie gì Sié-gái	Le Monde de Sophie
Ordovician	Ordovicien
Silurian	Silurien
Hók-gióng-sēng (Dṳ̆ng-huà Mìng-guók)	Province du Fujian
Mièu-lĭk	Comté de Miaoli
Dāng-nòng	Vésicule biliaire
Devonian	Dévonien
Hók-ciŭ	Fuzhou
Nàng-bìng	Nanping
Buò-dièng	Putian
Săng-mìng	Sanming
Ciòng-ciŭ	Quanzhou
Â-muòng	Xiamen
Ciŏng-ciŭ	Zhangzhou
Lṳ̀ng-ngàng	Longyan
Nìng-dáik	Ningde
Să̤-nìng	Xining
Să̤-iù-gé	La Pérégrination vers l'Ouest
Săng-guók Iēng-ngiê	Les Trois Royaumes (roman)
Cūi-hū	Au bord de l'eau
Ā-dŏng	Adam
Aomori-gâing	Préfecture d'Aomori
Fukushima-gâing	Préfecture de Fukushima
Tái-nguòng	Taiyuan
Hải Phòng	Hải Phòng
Sĭng-dé̤ṳk (gâing)	Comté de Hsinchu
Dâi-lièng	Dalian
Hĭ-Pŏ̤ Ciéng-cĕng	Guerres médiques
Permian	Permien
Biēu-chĭng	Cousin (famille)
Cambrian	Cambrien
Iòng-ciók	Bougie
Chiba-gâing	Préfecture de Chiba
Pău	Citrus maxima
Lô-dáik-gé	Livre de Ruth
Mà-hù	Anisoptera
Dáng-ī-lī	Livre de Daniel
Páuk-káik	Poker
Mô̤	Chapeau
Gŏ̤-lìng-dŏ̤ Cièng Cṳ̆	Première épître aux Corinthiens
Aichi-gâing	Préfecture d'Aichi
Lī-ngṳ̀	Carpe commune
Muāng-ciŭ	Mandchourie
Sê̤ṳ-sṳ-gé	Livre des Juges
Pŏ̤-lìng-chái	Épinard
Akita-gâing	Préfecture d'Akita
Pièu-gĕng	Cuillère
Dê̤ṳ	Baguettes (couverts asiatiques)
Mĕ̤k-lê	Jasmin
Nàng-dàu	Comté de Nantou
Gié-tiàng-chiă	Taxi
Â-hài	Menton (partie du visage)
Gŭ	Champignon
Ibaraki-gâing	Préfecture d'Ibaraki
Lài-gŭng	Tonnerre
Siĕu-sŏng	Acide nitrique
Ngù-giāng-kó	Jeans
Bō̤-siŏh	Gemme
Lièu-că̤ Cé-ê	Liaozhai zhiyi
Gáu-kuŏ-cṳ̆	Manuel scolaire
Chāu-māng	Caelifera
Dâng Gĭng	Zheng Jing
Diòng-chŭng	Changchun
Milan Kundera	Milan Kundera
Lâung	Œuf (cuisine)
Ū-ì-săng-chê	Wuyishan
Lĕ̤k-sé Sê̤ṳ-giông	Manifestations de la place Tian'anmen
Diêu Ciē-iòng	Zhao Ziyang
Hù Iêu-băng	Hu Yaobang
Fukuda Yasuo	Yasuo Fukuda
Sṳ̀ng-chéu (Sṳ̀ng-báh)	Pinaceae
Gī-hò̤-chiă	Compas (géométrie)
Táng-sŏng	Acide carbonique
Liòng-chióh	Règle (instrument de géométrie)
Chăng-màng-chṳ̄	Talpidae
Dṳ̆ng-hâ Iâ cĭ Máe̤ng	Le Songe d'une nuit d'été
Tié-tàu-să-hô	Barbier (métier)
Mā-kō̤ Hók Ĭng	Évangile selon Marc
Diê (dông-ŭk)	Huître
Kaesŏng	Kaesong
Hwanghae Báe̤k-dô̤	Hwanghae du Nord
P'yŏng'an Báe̤k-dô̤	Pyongan du Nord
Hamgyŏng Báe̤k-dô̤	Hamgyong du Nord
Hamgyŏng Nàng-dô̤	Hamgyong du Sud
P'yŏng'an Nàng-dô̤	Pyongan du Sud
Namp'o	Nampo
Ryanggang Dô̤	Ryanggang
Tò̤-huòng	Comté de Taoyuan
Sŭk-mī	Riz gluant
Nguòng-siĕu-uòng	Tangyuan (nourriture)
Gĭng-dŭ	Préfecture de Kyoto
Ōsaka-hū	Préfecture d'Osaka
Cék-ngṳ̀	Poisson rouge
Fukuoka-gâing	Préfecture de Fukuoka
Ehime-gâing	Préfecture d'Ehime
Gŏ̤-lìng-dŏ̤, Hâiu Cṳ̆	Deuxième épître aux Corinthiens
Gàu-ūng	Lumbricina
Sā̤-ĭ-gĭ	Machine à laver le linge
Gék	Mandarinier
Gé̤ṳ	Scie
Yamagata-gâing	Préfecture de Yamagata
Éu-dê-huòng	École maternelle
Dài-uăng Hāi-hiĕk	Détroit de Taïwan
Lù-guói	Aloès
Yamaguchi-gâing	Préfecture de Yamaguchi
Kanagawa-gâing	Préfecture de Kanagawa
Nagano-gâing	Préfecture de Nagano
Iĕng-huă	Feu d'artifice
Mì-pŏ̤-lù	Four à micro-ondes
Saitama-gâing	Préfecture de Saitama
Mie-gâing	Préfecture de Mie
Hĭ-báik-lài Cṳ̆	Épître aux Hébreux
Gă-lăk-tái Cṳ̆	Épître aux Galates
Muàng-ngṳ̀	Anguilliformes
Céng-gŏng	Jinjiang
Siŏng-dièu	Dynastie Shang
Gunma-gâing	Préfecture de Gunma
Hyōgo-gâing	Préfecture de Hyōgo
Miyazaki-gâing	Préfecture de Miyazaki
Kumamoto-gâing	Préfecture de Kumamoto
Ă-cì	Cicadidae
Koizumi Jun'ichirō	Jun'ichirō Koizumi
Liĕk-uòng-gé-liŏk Siông	Premier livre des Rois
Ī-sê̤ṳ-táik-cṳ̆	Livre d'Esther
Diòng-dô-cṳ̆	Ecclésiaste
Hatoyama Yukio	Yukio Hatoyama
Gŏ̤-lò̤-să̤ Cṳ̆	Épître aux Colossiens
Ngā-gáuk Cṳ̆	Épître de Jacques
Iók-hâng Ék Cṳ̆	Première épître de Jean
Pì-lé-muòng Cṳ̆	Épître à Philémon
Táik-sák-lò̤-nà̤-giă, Hâiu Cṳ̆	Deuxième épître aux Thessaloniciens
Táik-sák-lò̤-nà̤-giă Cièng Cṳ̆	Première épître aux Thessaloniciens
Bī-dáik Cièng Cṳ̆	Première épître de Pierre
Bī-dáik Hâiu Cṳ̆	Deuxième épître de Pierre
Tì-mò̤-tái Cièng Cṳ̆	Première épître à Timothée
Dòng-lòng	Mantodea
Gifu-gâing	Préfecture de Gifu
Ishikawa-gâing	Préfecture d'Ishikawa
Nara-gâing	Préfecture de Nara
Wakayama-gâing	Préfecture de Wakayama
Shizuoka-gâing	Préfecture de Shizuoka
Shiga-gâing	Préfecture de Shiga
Iók-hâng Nê Cṳ̆	Deuxième épître de Jean
Ī-suói-ā-cṳ̆	Livre d'Isaïe
Iók-hâng Săng Cṳ̆	Troisième épître de Jean
Iù-dâi Cṳ̆	Épître de Jude
Tì-mò̤-tái Hâiu Cṳ̆	Deuxième épître à Timothée
Tì-dŏ̤ Cṳ̆	Épître à Tite
Nùng-mìng	Agriculteur
Ià-lé-mī-cṳ̆	Livre de Jérémie
Ī-sê̤ṳ-lá-cṳ̆	Livre d'Esdras
Nà̤-hĭ-mī-cṳ̆	Livre de Néhémie
Iók-ngī-cṳ̆	Livre de Joël
Băh-lô	Aigrette garzette
Chŭng-cáik	Nouvel an chinois
Sō-siè	Clef (serrurerie)
Abe Shinzō	Shinzō Abe
Asō Tarō	Tarō Asō
Séng-cṳ̆-tā̤	Écriture hiéroglyphique égyptienne
Niigata-gâing	Préfecture de Niigata
Yamanashi-gâing	Préfecture de Yamanashi
Shimane-gâing	Préfecture de Shimane
Toyama-gâing	Préfecture de Toyama
Okayama-gâing	Préfecture d'Okayama
Piăng	Dos
Piĕ	Courrier
Sáik-màng	Daltonisme
Carboniferous	Carbonifère
Ciŏng-huá	Comté de Changhua
Fukui-gâing	Préfecture de Fukui
Ōita-gâing	Préfecture d'Ōita
Tottori-gâing	Préfecture de Tottori
Nùng-lĭk	Calendrier chinois
Kōchi-gâing	Préfecture de Kōchi
Uâng-iū īng-lĭk dêng-lŭk	Loi universelle de la gravitation
Chèng-gēng	Bombyx du mûrier
Dài-uăng Nĭk-buōng Sì-dâi	Taïwan sous domination japonaise
Páuk Gê̤ṳng-hiê	Park Geun-hye
Dài-nàng	Tainan
Cĕng	Aiguille à coudre
Muāng-cŭk	Mandchous
Kìng-giāng	Pince
Anna Karenina	Anna Karénine
Tài-nè̤ng	Homicide
Gáung-gṳ̆ng	Armature (technique)
Tiè-mà	Pleur
Swadesh hŏk-sĭng-sṳ̀ liĕk-biēu	Liste Swadesh
Dŭng-nìng-guók	Royaume de Tungning
Hùng-lìng	Comté de Yunlin
Kă-cāi	Orteil
Lāng	Salive
Diò-să-hô	Cuisinier
Bĭng-lòng	Palmier à bétel
Dâi-céng Tiĕng-huòng	Taishō Tennō
Băng-sièng Lā-mà	Panchen-lama
Mŭk-gê̤ṳng	Hibiscus syriacus
Muòi-huă	Abricotier du Japon
Cĕ̤ng-chéu	Trachycarpus fortunei
Muòi-kṳ̄ng	Moisissure
Gĭng-cá̤	Économie
Sĕ̤ng-săng-giāng	Jumeau
Mĕ̤k-tiák	Cil (anatomie)
Nguòng-cṳ̄-bék	Stylo à bille
Norodom Sihanouk	Norodom Sihanouk
Saga-gâing	Préfecture de Saga
Tokushima-gâing	Préfecture de Tokushima
Lòng-dâung	Hyoscyamus niger
Lòi-sĭ-gā	Tournevis
Kēng-muōi-dăi	Setaria italica
Kagawa-gâing	Préfecture de Kagawa
Mū-dăng	Paeonia suffruticosa
Thaksin Shinawatra	Thaksin Shinawatra
Uòng-dăi	Millet commun
Kê	Diospyros
Săng-guók (Dièu-siēng)	Trois Royaumes de Corée
Bék	Stylo
Ŭng-dìng	Poussière
Huăng-siŏh-liù	Goyavier
Duâi-tàu-giáng	Loupe
Gă-ngiê (gâing)	Comté de Chiayi
Ĭ-gŭng	Aïeul
Puái-dáu	Midi (culmination)
Huōi-căi	Incendie
Chiū-ló̤h	Gant
Nagasaki-gâing	Préfecture de Nagasaki
Hâ-dièu	Dynastie Xia
Cá̤-nàng	Jinan
Dṳ̆ng-guók Káung-nĭk Ciéng-cĕng	Guerre sino-japonaise (1937-1945)
Sarawak	Sarawak
Hŭng-cūi	Feng shui
Chiéu	Rire
Ngô̤-mâng gâe̤ng Piĕng-giéng	Orgueil et Préjugés
Oda Nobunaga	Oda Nobunaga
Dăng-hù	Corail
Lī Sìng-uāng	Syngman Rhee
Iòng-bék-chó̤	Gomme à effacer
Nàng-chiŏng	Nanchang
Tokugawa Ieyasu	Tokugawa Ieyasu
Bók-séu-gáung	Acier inoxydable
Sáu-chiū	Balai
Dŭk-cài	Autocratie
Kŭng-dièu	Climatisation
Diòng-să	Changsha
Pèng	Peinture (matière)
Mìng-dê Tiĕng-huòng	Meiji (empereur)
Kă-âu-dăng	Talon (anatomie)
Ā-mò̤-sê̤ṳ-cṳ̆	Livre d'Amos
Ŏ̤-bă-dī-ā-cṳ̆	Livre d'Abdias
Itō Hirobumi	Itō Hirobumi
Nguŏh	Jade
Só-gé̤ṳ-kó guāng-lī hiê-tūng	Système de gestion de base de données
Dâu-hô	Tofu
Mì-hèu	Macaque
Mī-giă-cṳ̆	Livre de Michée
Bù-sák	Bodhisattva
Hăk-gĭ-cṳ̆	Livre d'Aggée
Ī-să̤-giék	Livre d'Ézéchiel
Chiū-biēu	Montre (horlogerie)
ASP.NET	ASP.NET
Iók-nā-cṳ̆	Livre de Jonas
Sabah	Sabah
Ià-lé-mī-ăi-gŏ̤	Livre des Lamentations
Tái-gáng	Eunuque
Nàng-nìng	Nanning
Ê-só	Glutamate monosodique
Nā-ŭng-cṳ̆	Livre de Nahum
Hăk-bă-gók-cṳ̆	Livre de Habacuc
Sák-gā-lé-ă-cṳ̆	Livre de Zacharie
Guók-gê̤ṳng Nô̤i-ciéng	Guerre civile chinoise
Uŏk-nàng Gê̤ṳng-huò-guók	République du Viêt Nam
Chiĕu-chê	Supermarché
Ciŏng Cṳ̄-ì	Zhang Ziyi
Lák-tàu	Alopécie
Gulliver Lṳ̄-hèng-gé	Les Voyages de Gulliver
Gŏ̤-hṳ̀ng	Kaohsiung
Naha-chê	Naha
Buŏk-hāi	Mer de Bohai
Báh-chói	Bâillement
Hâung Ṳ̄	Xiang Yu
Putrajaya	Putrajaya
Kŏng-mìng	Kunming
Nĭk-guŏng-dĕng	Tube fluorescent
Jane Eyre	Jane Eyre
Johor	Johor
Ngâung	Handicap mental
Huòi-cŭk	Hui (ethnie)
Làng-ciŭ	Lanzhou
Hŏ̤-să̤-cṳ̆	Livre d'Osée
Tiék-cĭng	Rouille (oxyde)
Dĕ̤ng-kiĕ	Sepiida
Lìng Cáik-sṳ̀	Lin Zexu
Săng-guók	Trois Royaumes de Chine
Chŭng-chiŭ Sì-dâi	Période des Printemps et Automnes
Ciéng-guók Sì-dâi	Période des Royaumes combattants
Puō-ngì	Puyi
Mā-lăk-gă	Malacca (État)
Oracle	Oracle Database
Hăk-bùi	Hefei
Huák-lùng-gŭng	Falun Gong
Kelantan	Kelantan
Lŏk-iòng	Luoyang
Toyotomi Hideyoshi	Toyotomi Hideyoshi
Kana	Kana
Câung-cŭk	Tibétains
Pulau Pinang	Penang
Hamasaki Ayumi	Ayumi Hamasaki
Să̤-huăng-ngā-cṳ̆	Livre de Sophonie
Dâi-nĭk-buōng Dá̤-guók	Empire du Japon
Hṳ̆ng-nù	Xiongnu
Mâing-cṳ̄	Mencius
Kedah	Kedah
Perak	Perak
Hŏk-ôi	Grade universitaire
Gié-lìng	Guilin
Terengganu	Terengganu
Selangor	Selangor
Iòng (dông-ŭk)	Caprinae
Hāi-kāu	Haikou
Chāu-buōng sĭk-ŭk	Plante herbacée
Pahang	Pahang
Bă-là̤ Séng-mū-iêng (Siēu-siók)	Notre-Dame de Paris (roman)
Chiông-gì	Xiangqi
Yun Chi-ho	Yun Chi-ho
Gói-iòng	Guiyang
Gáung-bék	Stylo-plume
Ngù Dìng-iēng	Ngô Đình Diệm
Gô-dā̤	Passé
Dĭng-hiŏng-kó̤	Engraulidae
Miêng	Nouille
Lèng-gēng	Dimocarpus longan
Mì-lĕk-hŭk	Maitreya
Guăng-ĭng	Avalokiteśvara
Bìng-dĕ̤ng	Comté de Pingtung
Gēu-gī	Lycium barbarum
Lĕ̤k-dèu-gáuk	Côte (os)
Ciŏng-bìng	Zhangping
Ciŏng-puō	Xian de Zhangpu
Ciéu-ăng	Xian de Zhao'an
Dâng Sìng-gŭng	Koxinga
Céng-huò	Xian de Zhenghe
Ciá-ìng	Xian de Zherong
Nguŏk-biāng	Gâteau de lune
Ciŭ Īng-kŏng	Zhou Yongkang
Ciŭ-nìng	Xian de Zhouning
Cṳ̆-gák Liông	Zhuge Liang
Ció-ĭng Hù-hô̤	Bopomofo
Tù-kēng	Gryllotalpidae
Dṳ̆ng-guók Ìng-mìng Gāi-huóng-gŭng	Armée populaire de libération
Sìng-ū Tiĕng-huòng	Jinmu
Kūng-chiók	Paon
Ciē-chái	Nori
Dennis Rodman	Dennis Rodman
È̤ng-dà	Thé noir
Cò̤ Chó̤	Cao Cao
Lièng-gŏng	Xian de Lianjiang
Tài-tàu	Décapitation
Cūi-ngù	Cerambycidae
Hiŏng-siàng	District de Xiangcheng (Zhangzhou)
Buŏi	Vol (aéronautique)
Ŭi-nà̤-sṳ̆ Sĕng-lī-nè̤ng	Le Marchand de Venise
Ū-ì-săng	Monts Wuyi
Ŭ-sŭ-lī-gĕ̤ng	Oussouri
Tiĕng-huòng	Empereur du Japon
Kăi-hŭng	Kaifeng
Sĭng-dài-bê	Nouveau dollar de Taïwan
Sák-mū-ngī-gé-hâiu-cṳ̆	Deuxième livre de Samuel
Lăk-dâi-cé-liŏk Hâ	Deuxième livre des Chroniques
Liĕk-uòng-gé-liŏk Hâ	Deuxième livre des Rois
Nguòng Sié-kāi	Yuan Shikai
Gă-lṳ̀ng Huòng-dá̤	Gia Long
John Wesley	John Wesley
Siăh	Alimentation
Perlis	Perlis
Negeri Sembilan	Negeri Sembilan
Labuan	Territoire fédéral de Labuan
Lṳ̀ng	Dragon oriental
Iòng-iù-gàu	Lampe à pétrole
Cần Thơ	Cần Thơ
Gĭng-cŭk	Viêt
Ciĕng-bò̤	Royaume de Champā
Diòng-gáu-sê̤ṳ	Missionnaire chrétien
Uōng-dâi Cièng-tiàng	Les Grandes Espérances
Niōng-bēng	Plafond (architecture)
Rasŏn	Rasŏn
Guăng Ṳ̄	Guan Yu
Ŭ-gŭi	Tortue
Tá̤	Tiroir
Gê̤ṳng-huò-dōng	Parti républicain
Bō̤-dâi Huòng-dá̤	Bảo Đại
Siê-iù	Sauce de soja
Ŭ-lṳ̀ng-dà	Thé Oolong
Huōi-lṳ̀ng-guō	Pitaya
Chái Ĭng-ùng	Tsai Ing-wen
Băh-cṳ̄ng-nè̤ng	Blanc (humain)
Ŏ̤-mì-tò̤-hŭk	Amitābha
Ngiè-làng	Comté de Yilan
Ciŭ Giĕk-lùng	Jay Chou
Orhan Pamuk	Orhan Pamuk
Hà-puō	Xian de Xiapu
Carpineto Romano	Carpineto Romano
Ngū-dâi Sĕk-guók	Période des Cinq Dynasties et des Dix Royaumes
Cō̤	Jujubier commun
Tā̤-ṳ̆k	Éducation physique et sportive
Sĭng-báe̤k	Nouveau Taipei
Dài-dṳ̆ng	Taichung
Làu Bê	Liu Bei
Huă-lièng	Comté d'Hualien
Gĭng-muòng	Jinmen
Dài-dĕ̤ng	Comté de Taitung
Sĭng-dé̤ṳk (chê)	Hsinchu
Gă-ngiê (chê)	Chiayi
Giĕ-lè̤ng	Keelung
Săi	Sai
Jun Ji-hyun	Jeon Ji-hyeon
Ngiè	Oie domestique
Dièu-siēng Gŏ̤-cŭng	Kojong
Hók-chiăng	Fuqing
Gáuk-gáuk	Os
Amuro Namie	Namie Amuro
Diêng-tù	Pile électrique
Gê̤ṳ-gê̤ṳ	Béquille (médecine)
Nakashima Mika	Mika Nakashima
Hù-lì-mà	Vison de Sibérie
Gŏ̤-ák-guŏ	Autocuiseur
Chagang Dô̤	Jagang (Corée du Nord)
Óng-chái	Ipomoea aquatica
Ké̤ṳk-siăh	Mendiant
Sŏng-ngù	Royaume de Wu
Băh-cŭk	Bai (ethnie)
Siông Cĭng	Shō Shin
Mùi-liĕk	District de Meilie
Huòng Tái-gĭk	Huang Taiji
Guŏng-sê̤ṳ Huòng-dá̤	Guangxu
Alan Dawa Dolma	Alan Dawa Dolma
Ngù-mō̤-ngù-giāng	Escargot
Takeshi Kaneshiro	Takeshi Kaneshiro
Sông-dê Huòng-dá̤	Shunzhi
Nū-ī-hăk-cà̤	Nurhachi
Iòng-muòi	Myrica rubra
Sŏng Guòng	Sun Quan
Cò̤ Pī	Cao Pi
Ciōng Gĭng-guók	Chiang Ching-kuo
Uòng Mì	Wang Wei
Lī Dĕng-hŭi	Lee Teng-hui
Ṳ̆ng-céng Huòng-dá̤	Yongzheng
Dùng-dê Huòng-dá̤	Tongzhi
Dŭng-huòng	Dunhuang
Să-mŏk	Erg (dune)
Hiŏng-iòng-guă	Chayote
Uòng Ăng-sĭk	Wang Anshi
Tokugawa Yoshimune	Tokugawa Yoshimune
Săng-ā	Sanya
Dài-uăng Mìng-ciō-guók	République de Formose
Seo Jae-pil	Philip Jaisohn
Guók-ngṳ̄	Langue nationale
Sṳ̆k-háng	Royaume de Shu
Cò̤-ngôi	Royaume de Wei
Hiŏng-gŭ	Lentinula edodes
Mŭk-ngī	Oreille de Judas
Sā̤-tŏng	Baignade
Gă-kéng Huòng-dá̤	Jiaqing
Páuk Hièng-īng	Pak Hon-yong
Dièu-siēng Sié-cū	Sejo
Dô̤-guŏng Huòng-dá̤	Daoguang
Hièng-hŭng Huòng-dá̤	Xianfeng
Hùng Séu-ciòng	Hong Xiuquan
Gĭng-kiŏk	Opéra de Pékin
Bău Cīng	Bao Zheng
Báik-guá	Ba gua
Sṳ̆-mā Hé	Sima Yi
Hŭng-sṳ̆k	Convention (droit)
Ièu-cŭk	Yao (peuple d'Asie)
Bĭng-sĭng	Bing Xin
Biék	Trionychidae
Dièu-siēng Tái-cū	Taejo
Báik-nguŏk-cáik	Fête de la mi-automne
Guŏng-Dṳ̆ng Huòng-dá̤	Nguyễn Huệ
Ngà̤ Táuk-sĭng	Watchman Nee
Liŏh-chiông-gĭ	Magnétoscope
Dâng-chái	Mytilidae
Gā-cō̤	Siphonaptera
Mā-tái Hók Ĭng	Évangile selon Matthieu
Sĕk-cê-gá	Croix (christianisme)
Tè̤ng-chō̤	Ophiocordyceps sinensis
Ī-hók-sū Cṳ̆	Épître aux Éphésiens
Sìng	Sing
Mā-cū (Sìng)	Mazu
Mìng	Ming
Uŏk-nàng Gê̤ṳng-sāng-dōng	Parti communiste vietnamien
10000	10 000 (nombre)
Kū-guă	Momordica charantia
Mìng-miâng Huòng-dá̤	Minh Mạng
Chék Gié-guŏng	Qi Jiguang
Dĭk Ìng-giĕk	Di Renjie
Dṳ̆ng-huà Mìng-guók Guók-gŭng	Armée de la République de Chine
Ì-cŭk	Yi (ethnie)
Gāu-nguŏk-gāu	Fête du double neuf
Dâing Lâ̤-gŭng	Teresa Teng
Mìng-sìng Huòng-hâiu	Impératrice Myeongseong
Natsukawa Rimi	Rimi Natsukawa
Lṳ̄ Séu-lièng	Annette Lu
Sê̤ṳ-dáik Huòng-dá̤	Tự Đức
Cṳ̀-ciŏng	Carrelage
Ngù Săng-gié	Wu Sangui
Hĭng-sŏng Dâi-iêng-gŭng	Daewongun
Gŏ̤ Dé-sêng	Gao Zhisheng
Dêu-uòng	Di Xin
Hàng Hàng	Han Han
Huăng-giāng	Étranger
Tiăng-dŏng	Salle de séjour
Ók-dāu	Fer à repasser
Liŏh-dà	Thé vert
Liŏh-dâu	Haricot mungo
Dièu-siēng-cŭk	Coréens
Yu Kil-chun	Yu Kil-chun
Mò̤-bék	Pinceau de calligraphie
Páuk Hông-ciŏ	Pak Pong-ju
Hŭk-dáng Dâi-hŏk	Université Fudan
Páuk Dṳ̀ng-iòng	Park Jung-yang
Lêng Gié-hĕk	Ling Jihua
Hòng-ciŭ Să̤-hù	Lac de l'Ouest
Gă-săk-giāng	Petite citadine
Gái-chái	Moutarde brune
Siông-hāi Gău-tŭng Dâi-hŏk	Université Jiao-tong de Shanghai
Bù-sìng	Muscidae
Ciū-ciòng	Jiuquan
Hŭ-huò-hô̤-dĕk	Hohhot
Ngù Chĭng-nguòng	Go Seigen
Hà-iù	Nuoc-mâm
Băh-ngiê	Termite
Băh-uâ-cê	Pe̍h-ōe-jī
Ngièng Hók	Yan Fu
Páu-diông	Pétard
Hṳ̆ng-dòng	Thorax
Mā-cū (Dō̤)	Îles Matsu
Ăng-kă̤	Xian d'Anxi
Să̤-cŏng	Complet (vêtement)
Ìng-cṳ̄	Fils de l'Homme
Hiroshima-gâing	Préfecture de Hiroshima
Hwanghae Nàng-dô̤	Hwanghae du Sud
Hók-tīng	Fuding
Siĕu-ciū	Baijiu
Dùng-cé	Camarade
Hŭng-tiŭ	Pompe à vélo
Gióng-iòng	Jianyang (Fujian)
Dáng-mìng	Tanka (minorité)
Mìng-kă̤	Xian de Mingxi
Guōng-guă	Courge cireuse
Sīng Bō̤-dĭng	Shen Baozhen
Hùng-siĕu	Xian de Yunxiao
Káh-gă	Hakka
Bâng-ā	Mutisme
Nàng-gĭng Dâi-hŏk	Université de Nankin
Chék-nguŏk-buáng	Fête des fantômes
Uòng Sĭng-lìng	Cyndi Wang
Cò̤ Sĭk	Cao Zhi
Ciŭ Ùng-uòng	Wen Wang
Huò-sĭng	Heshen
Bō̤-sĕng Dâi-dá̤	Baoshengdadi
Giŏng Tái-gŭng	Jiang Ziya
Tái-sông	Xian de Taishun
Chŏng-nàng	Xian de Cangnan
Lìng Sĕng	Lin Sen
Buò-gì	Livistona chinensis
Cūi-giĕ	Hoplobatrachus rugulosus
Dìng Gēng	Trần Thái Tông
Dièu-siēng Buáng-dō̤ lĭk-sṳ̄	Histoire de la Corée
Cáe̤ng	Zongzi
Iù-cák-guōi	You Tiao
Sinŭiju Dĕk-biék Hèng-céng-kṳ̆	Région administrative spéciale de Sinŭiju
Guók-lĭk Dṳ̆ng-iŏng Dâi-hŏk	Université nationale centrale
Tūng-ék Sĭng-lò̤	Période Silla
Sák Déng-bĭng	Sa Zhenbing
Dìng Gīng-ê̤ṳng	Chen Jingrun
Lìng Chṳ̆	Lin Shu
Huá-huá	Martin huppé
Lī Gŭng-ūng	Lý Thái Tổ
Hók-gióng tū-làu	Tulou du Fujian
Chĭng-mìng	Qingmingjie
Nê-hù	Erhu
Pū-tŭng-uâ	Mandarin standard
Siă-cŭk	She
Mē̤ng-giāng	Psychodidae
Mĭk-pŭng	Apidae
Okinawa-gâing	Préfecture d'Okinawa
Diòng-lŏ̤h	Changle
Nàng-ā	Asie du Sud
Guòng-lé	Droits et libertés
Gióng-nìng	Xian de Jianning
Gŭng-sĭ	Compagnie (entreprise)
Tŏng-diè-dáing	Bains publics
Tì-kŭ	Scomber japonicus
Ŭ-cṳ̄ng-nè̤ng	Noir (humain)
Nàng-uŏk-guók	Nanyue
Hâ-uă	Ève
Chèng-chṳ̄	Arvicolinae
Kiŏng-cŭk	Qiangs
Chèng	Terre arable
Chái Ŭng	Sai On
Nà̤-gŭ	Bhikkhuni
Bĭng-dê̤ṳ	Glace à l'eau
Ngṳ̆k-huòng-dâi-dá̤	Empereur de jade
Ngù-sāi-gŭi	Bousier
À̤-liák	Chausson
Lī-dièu	Dynastie Lý
Cé̤ṳk	Congee
Dĕ̤ng-cáik	Solstice d'hiver (fête chinoise)
Mìng-ciō Céng-buô-dōng	Parti démocrate progressiste (Taïwan)
Siông Mŭk	Shō Boku
Siông Dáik	Shō Toku
Siông Nguòng	Shō Gen
Siông Ṳ̆k	Shō Iku
Siông Nìng	Shō Nei
Ì-cô̤-hūng	Lessive
Pàng-hù Gùng-dō̤	Îles Pescadores
Hāi-chŏng	District de Haicang
Muōi-sì	Châtaigne d'eau chinoise
Hāi-nàng-ngṳ̄	Hainanais
Dĕ̤ng-săng	Xian de Dongshan
Cĭk-mī	District de Jimei
Mìng-gĕ̤ng	Min (fleuve, Fujian)
Dùng-ăng	District de Tong'an
Dài-gĕ̤ng	District de Taijiang
Lṳ̀ng-hāi	Longhai
Siŏh-săi	Shishi
Siòng-ăng	District de Xiang'an
Mìng-âu	Xian de Minhou
Siêu-ū	Shaowu
Ôi	Estomac
Chŏng-săng	District de Cangshan
Siông Géng	Shō Kei
Hāi-gēu	Arctocephalinae
Sibu	Sibu
Siông Ŭng	Shō On
Lū-bék	Bulbul de Chine
Ciŭ Ū-uòng	Zhou Wuwang
Diòng-tái	Xian de Changtai
Diòng-tĭng	Xian de Changting
Cṳ̆-dó̤h	Bureau (meuble)
Siàng-siŏng	District de Chengxiang
Chèng-lòi	Viviparidae
Siông Ièng	Shō En
Lī-siàng	District de Licheng (Quanzhou)
Ciòng-gē̤ng	District de Quangang
Siông Hô̤	Shō Kō
Ĕ̤ng-ngiê	Tetramorium
Chiă-ngò̤	Meretrix lusoria
Aragaki Yui	Yui Aragaki
Siông Chĭng	Shō Sei
Siông Tái-giū	Shō Taikyū
Sô̤i	Station assise
Siĕu	Dizi
Mā-lái-iè	Babouk
Sêu-nìng	Xian de Shouning
Lŏk-gŏng	District de Luojiang
Â-muòng Dâi-hŏk	Université de Xiamen
Kŭ-chèng	Xian de Gutian
Dâi-dièng	Xian de Datian
Dáik-huá	Xian de Dehua
Cáik-ké	Période solaire
Gák-lì	Palourde
Hà-mà-chāu	Plantago asiatica
Là̤ Lé	Lê Lợi
Huà-ăng	Xian de Hua'an
Nìng-huá	Xian de Ninghua
Iù-kă̤	Xian de Youxi
Chĭng-liù	Xian de Qingliu
Să-gâing	Xian de Sha
Gāi-gáik Kăi-huóng	Réforme économique chinoise
Lièng-siàng	Xian de Liancheng
Sông-chiŏng-gâing	Xian de Shunchang
Lò̤-nguòng	Xian de Luoyuan
Bìng-nàng	Xian de Pingnan (Fujian)
Bìng-tàng	Xian de Pingtan
Nàng-ăng	Nan'an
Dṳ̀-huák	Division
Hù-lù	Lagenaria siceraria
Ciŏng-lŏk	Xian de Jiangle
Gĭng-dĭk	Jingzhe
Diêng-dĕng	Lampe électrique
Tiék-guăng-ĭng	Tieguanyin
Hù-lī	District de Huli
Īng-dêng	Xian de Yongding
Sṳ̀ Cài-hâiu	Xu Caihou
Céng-ăng	District de Jin'an (Fuzhou)
Gū-làu	District de Gulou (Fuzhou)
Séu-sê̤ṳ	District de Xiuyu
Īng-chŭng	Xian de Yongchun
Ciĕu-siàng	District de Jiaocheng
Siĕng-iù	Xian de Xianyou
Iòng-bìng-kṳ̆	District de Yanping
Sĭng-lò̤-kṳ̆	District de Xinluo
Puō-siàng	Xian de Pucheng (Fujian)
Săng-nguòng	District de Sanyuan
Hàng-gŏng	District de Hanjiang (Putian)
Hŭng-dĕk	District de Fengze
Lié-siàng	District de Licheng (Putian)
Siông-hòng-gâing	Xian de Shanghang
Sṳ̀ng-kă̤-gâing	Xian de Songxi
Ū-bìng	Xian de Wuping
Nàng-cêng	Xian de Nanjing
Lĭk-chŭng	Lichun
Ṳ̄-cūi	Yushui
Siông Bă-cé	Shō Hashi
Siông Tái	Shō Tai
Hók-ăng	Fu'an
Mìng-chiăng	Xian de Minqing
Gióng-ĕu	Jian'ou
Mā-muōi	District de Mawei
Īng-tái	Xian de Yongtai
Lṳ̀ng-ùng	District de Longwen
Sṳ̆-mìng	District de Siming
Hiê-ăng	Xian de Hui'an
Bìng-huò	Xian de Pinghe
Tái-nìng	Xian de Taining
Guŏng-dĕk	Xian de Guangze
Īng-ăng	Yong'an
分類:Dáik-guók	Catégorie:Allemagne
分類:É-dâi-lé	Catégorie:Italie
分類:Mī-guók	Catégorie:États-Unis
分類:Ngò̤-lò̤-sṳ̆	Catégorie:Russie
分類:Dṳ̆ng-guók	Catégorie:Chine
分類:Nĭk-buōng	Catégorie:Japon
分類:Ó̤-ciŭ	Catégorie:Australie
分類:Éng-nà̤	Catégorie:Indonésie
分類:Hàng-guók	Catégorie:Corée du Sud
分類:Tái-guók	Catégorie:Thaïlande
分類:Uŏk-nàng	Catégorie:Viêt Nam
分類:Buô-ṳ̄ dông-ŭk	Catégorie:Mammifère
分類:Bà-hèng dông-ŭk	Catégorie:Reptile
分類:Cēu	Catégorie:Oiseau
分類:Cĭng-kṳ̄ng	Catégorie:Fungi
分類:Sĭk-ŭk	Catégorie:Plante
分類:Ŭk-lī	Catégorie:Physique
分類:Huá-hŏk	Catégorie:Chimie
分類:Lĭk-sṳ̄	Catégorie:Histoire
分類:Dê-lī	Catégorie:Géographie
分類:Siâ-huôi	Catégorie:Société
分類:Mī-sŭk	Catégorie:Art visuel
分類:Cŭng-gáu	Catégorie:Religion
分類:Tā̤-ṳ̆k	Catégorie:Sport
分類:Kuŏ-hŏk	Catégorie:Sciences
分類:Gióng-dé̤ṳk-ŭk	Catégorie:Bâtiment
Gū Lò̤-mā	Rome antique
Liù-giāng	Corbiculidae
Regina Duarte	Regina Duarte
Mìng-uŏk	Minyue
Cūi-kì	Limace
分類:Sĕng-tái	Catégorie:Écologie
Sák-mū-ngī-gé-cièng-cṳ̆	Premier livre de Samuel
分類:Diék-hŏk	Catégorie:Philosophie
分類:Sĭng-lī	Catégorie:Psychologie
分類:Hŭk-gáu	Catégorie:Bouddhisme
分類:Gĭ-dók-gáu	Catégorie:Christianisme
分類:Ĭ-sṳ̆-làng-gáu	Catégorie:Islam
分類:Iù-tái-gáu	Catégorie:Judaïsme
Kiê	Station debout
Tiĕng-cĭng Dâi-hŏk	Université de Tianjin
Mā-cū	Matsu (homonymie)
Dĭ-dă	Suona
Gùng	Jupe
Cháe̤	Courge éponge
Tuyên Quang	Province de Tuyên Quang
Lìng Sié-gŭng	Rin Seikō
Hióng Dáik-hèng	Kōchi Chōjō
Dà-gī	Table basse
Iraq gâe̤ng Levant Ĭ-sṳ̆-làng-guók	État islamique (organisation)
Pàng-kì	Sesarmidae
Chiòng (dông-cáuk)	Position accroupie
Giū-mī-chŏng	Kumemura
Ì-ngṳ̄	Yi (langue)
Cièng-cāi	Billet funéraire
Tău-dò̤-nó̤h	Vol (droit)
Ciĕ-muài	Sésame
Abu Bakr al-Baghdadi	Abou Bakr al-Baghdadi
Sé-sáik-bà̤	Bài
分類:Ùng-huá	Catégorie:Culture
分類:Dê-cék	Catégorie:Géologie
Dìng-dièu	Dynastie Trần
Wikipedia:Dŏng-nièng gĭng-dáng	Wikipédia:Éphéméride
模板:Tái-iòng-hiê	Modèle:Palette Système solaire
Holopedia	Wikipédia en minnan
Ciē-sáik	Pourpre
Gâng	Sueur
Sìng (bòng-hâ̤)	Scylla serrata
Sók-lŭk	Vitesse
Ák	Canard
Duâi-tàu-chái	Navet
Huăng-siông	Manguier
分類:Dáik-guók ìng-ŭk	Catégorie:Personnalité allemande
分類:Mī-guók ìng-ŭk	Catégorie:Personnalité américaine
分類:Iēng-uòng	Catégorie:Acteur
分類:Ĭng-guók ìng-ŭk	Catégorie:Personnalité britannique
分類:Huák-guók ìng-ŭk	Catégorie:Personnalité française
模板:Chess diagram	Modèle:Diagramme d'échecs
模板:Tl	Modèle:M
分類:Guók-gă	Catégorie:Pays
Wikipedia:Hèng-céng Ìng-uòng	Wikipédia:Administrateur
分類:Dṳ̆ng-guók mìng-cŭk	Catégorie:Groupe ethnique de Chine
分類:Ìng-ŭk	Catégorie:Personnalité
分類:Cék-ngiĕk	Catégorie:Métier
Wikipedia:Gĭ-ké-nè̤ng	Wikipédia:Bot
分類:Sì-găng	Catégorie:Temps
分類:Gĕ̤ng-tiàng	Catégorie:Ingénierie
分類:Cài-lâiu	Catégorie:Matériau
分類:Ĭ-hŏk	Catégorie:Médecine
分類:Céng-dê	Catégorie:Politique
分類:Gáu-ṳ̆k	Catégorie:Éducation
Ăi-gĭk	Égypte
模板:Bot	Modèle:Bot
Gă-nā-dâi	Canada
分類:Iù-hié	Catégorie:Jeu
分類:Ĕu-ciŭ guók-gă	Catégorie:Pays d'Europe
分類:Ĕu-ciŭ	Catégorie:Europe
模板:Documentation	Modèle:Documentation
分類:Ê̤ṳng-hô	Catégorie:Wikipédiens par langue
Sìng Câi-gĭ	Sung Jae-ki
模板:Softredirect	Modèle:Redirection douce
Wikipedia:維基數據	Wikipédia:Wikidata
模板:Chēng	Modèle:Suppression Immédiate
分類:Ngṳ̄-ngiòng	Catégorie:Langue
分類:Lĭk-huák	Catégorie:Calendrier
分類:Wikipedia	Catégorie:Wikipédia
Wikipedia:Mò̤ hô-cáik sĭng-mìng	Wikipédia:Avertissements généraux
Dâi-chṳ̄	Kangourou
模板:!	Modèle:!
模板:!-	Modèle:!-
模板:Smallcaps	Modèle:Petites capitales
模板:Nowrap	Modèle:Nobr
Wikipedia:Ék-chiék Wikipedia dŭ găi-dŏng ô gì ùng	Wikipédia:Articles vitaux
分類:Hĭ-ciŭ	Catégorie:Afrique
模板:Wikisource	Modèle:Wikisource
模板:Babel	Modèle:Boîte Babel
模板:Commons	Modèle:Commons
模板:Reflist	Modèle:Références
Wikipedia:列明來源	Wikipédia:Citez vos sources
模板:Stub	Modèle:Ébauche
模板:User eo-1	Modèle:Utilisateur eo-1
模板:User eo-3	Modèle:Utilisateur eo-3
模板:User de	Modèle:Utilisateur de
模板:User de-1	Modèle:Utilisateur de-1
模板:User es	Modèle:Utilisateur es
模板:User de-3	Modèle:Utilisateur de-3
模板:User en-3	Modèle:Utilisateur en-3
模板:User en-1	Modèle:Utilisateur en-1
模板:User en-2	Modèle:Utilisateur en-2
模板:User eo-2	Modèle:Utilisateur eo-2
模板:User en-4	Modèle:Utilisateur en-4
模板:User en	Modèle:Utilisateur en
模板:User de-2	Modèle:Utilisateur de-2
模板:User es-1	Modèle:Utilisateur es-1
模板:User fr-1	Modèle:Utilisateur fr-1
模板:User it-3	Modèle:Utilisateur it-3
模板:User fr-2	Modèle:Utilisateur fr-2
模板:User ja	Modèle:Utilisateur ja
模板:User ja-1	Modèle:Utilisateur ja-1
模板:User it-1	Modèle:Utilisateur it-1
模板:User fr	Modèle:Utilisateur fr
分類:Ā-ciŭ	Catégorie:Asie
分類:Nàng Mī-ciŭ	Catégorie:Amérique du Sud
分類:Mā-lài-să̤-ā	Catégorie:Malaisie
模板:Mod	Modèle:Mod
模板:SIL	Modèle:Lien ISO 639-3
模板:User it	Modèle:Utilisateur it
模板:User es-2	Modèle:Utilisateur es-2
模板:Huăng-ngìng	Modèle:Bienvenue nouveau
分類:Dièu-lâiu	Catégorie:Condiment
分類:User fr-1	Catégorie:Utilisateur fr-1
模板:Image label	Modèle:Image label
模板:Wiki gĕ̤ng-tiàng	Modèle:Palette Wikimedia Foundation
模板:Niék-sé cáik-ké	Modèle:Palette Périodes solaires
模板:Steady	Modèle:Stagnation
模板:Guók-gă	Modèle:Infobox Pays
模板:Documentation/docname	Modèle:Documentation/docname
模板:Cite journal	Modèle:Article
模板:Infobox 公司	Modèle:Infobox Société
模板:Hō̤ gì ùng-ciŏng	Modèle:Article de qualité
分類:User en-4	Catégorie:Utilisateur en-4
分類:User en	Catégorie:Utilisateur en
分類:User zh	Catégorie:Utilisateur zh
分類:User zh-M	Catégorie:Utilisateur zh-M
分類:User en-2	Catégorie:Utilisateur en-2
模板:User eo	Modèle:Utilisateur eo
模板:User zh	Modèle:Utilisateur zh
分類:Gáuk-guók gì lĭk-sṳ̄	Catégorie:Histoire par pays
模板:Legend	Modèle:Légende
模板:Cite web	Modèle:Lien web
模板:Country data	Modèle:Country data
Wikipedia:Dŏng-nièng gĭng-dáng/10 nguŏk 5 hô̤	Wikipédia:Éphéméride/5 octobre
分類:Īng-sĭk	Catégorie:Alimentation
模板:MongolUnicode	Modèle:Mongol
分類:Săng	Catégorie:Montagne
模板:IPA	Modèle:Prononciation API
分類:Céng-dê-gă	Catégorie:Personnalité politique
分類:Mī-ciŭ	Catégorie:Amérique
Tàng	Glaire (sécrétion)
分類:Gáuk-guók gì ìng-ŭk	Catégorie:Personnalité par nationalité
模板:Wiki-huá	Modèle:À wikifier
分類:Gŭng-sê̤ṳ	Catégorie:Armée
模板:Increase	Modèle:Augmentation
模板:Ciŭ-gĭ-biēu	Modèle:Tableau périodique (navigation)
模板:User nl	Modèle:Utilisateur nl
模板:Infobox 網站	Modèle:Infobox Site web
模板:Decrease	Modèle:Diminution
模板:User no-2	Modèle:Utilisateur no-2
模板:Image label end	Modèle:Image label fin
模板:Documentation subpage	Modèle:Sous-page de documentation
模板:Purge	Modèle:Purger le cache
模板:Lang-la	Modèle:Lang-la
分類:Cìng-gāng	Catégorie:Émotion
模板:Dṳ̆ng-huà Ìng-mìng Gê̤ṳng-huò-guók Hèng-céng-kṳ̆	Modèle:Palette Subdivisions de la Chine
模板:Userpage	Modèle:Page personnelle
模板:Non-free logo	Modèle:Marque déposée
模板:User	Modèle:U
模板:Image label small	Modèle:Image label small
模板:User fr-3	Modèle:Utilisateur fr-3
模板:Gô-dā̤ gì guók-gă	Modèle:Infobox Ancienne entité territoriale
分類:User ja-M	Catégorie:Utilisateur ja-M
模板:Gì-ngiê	Modèle:Homonymie
分類:Dièu-siēng lĭk-sṳ̄	Catégorie:Histoire de la Corée
模板:User no-3	Modèle:Utilisateur no-3
模板:User nan	Modèle:Utilisateur zh-min-nan
模板:User nan-1	Modèle:Utilisateur zh-min-nan-1
模板:Lang-grc	Modèle:Lang-grc
模板:User ksh	Modèle:Utilisateur ksh
模板:AUS	Modèle:Australie
模板:User yue-1	Modèle:Utilisateur zh-yue-1
模板:Lang-en	Modèle:Lang-en
Wikipedia:Dŏng-nièng gĭng-dáng/9 nguŏk	Wikipédia:Éphéméride/septembre
Wikipedia:Dŏng-nièng gĭng-dáng/10 nguŏk	Wikipédia:Éphéméride/octobre
分類:User vi-3	Catégorie:Utilisateur vi-3
模板:User la-1	Modèle:Utilisateur la-1
分類:User wuu	Catégorie:Utilisateur wuu
分類:User fr	Catégorie:Utilisateur fr
分類:User ja	Catégorie:Utilisateur ja
分類:User la	Catégorie:Utilisateur la
分類:User fr-3	Catégorie:Utilisateur fr-3
分類:User it-3	Catégorie:Utilisateur it-3
分類:User ja-3	Catégorie:Utilisateur ja-3
分類:User fr-2	Catégorie:Utilisateur fr-2
分類:User it-2	Catégorie:Utilisateur it-2
分類:User ja-2	Catégorie:Utilisateur ja-2
分類:User la-2	Catégorie:Utilisateur la-2
分類:User wuu-M	Catégorie:Utilisateur wuu-M
分類:User ko-M	Catégorie:Utilisateur ko-M
分類:User fr-M	Catégorie:Utilisateur fr-M
分類:User it-M	Catégorie:Utilisateur it-M
分類:User nl-M	Catégorie:Utilisateur nl-M
模板:User yue	Modèle:Utilisateur yüt
分類:Ùng-cê	Catégorie:Système d'écriture
分類:Dô̤-gáu	Catégorie:Taoïsme
分類:Dō̤	Catégorie:Île
分類:User de	Catégorie:Utilisateur de
分類:User de-2	Catégorie:Utilisateur de-2
分類:User de-3	Catégorie:Utilisateur de-3
分類:User de-M	Catégorie:Utilisateur de-M
分類:User en-3	Catégorie:Utilisateur en-3
分類:User en-M	Catégorie:Utilisateur en-M
分類:User es	Catégorie:Utilisateur es
分類:User es-1	Catégorie:Utilisateur es-1
分類:User es-2	Catégorie:Utilisateur es-2
分類:User es-3	Catégorie:Utilisateur es-3
分類:User es-M	Catégorie:Utilisateur es-M
分類:Chió	Catégorie:Logement
分類:User it	Catégorie:Utilisateur it
分類:User it-1	Catégorie:Utilisateur it-1
分類:User ja-1	Catégorie:Utilisateur ja-1
分類:User ko	Catégorie:Utilisateur ko
分類:Mī-guók gì ciŭ	Catégorie:État des États-Unis
分類:User ko-1	Catégorie:Utilisateur ko-1
分類:User ko-2	Catégorie:Utilisateur ko-2
分類:User ko-3	Catégorie:Utilisateur ko-3
分類:User ksh	Catégorie:Utilisateur ksh
分類:User ksh-M	Catégorie:Utilisateur ksh-M
分類:User la-1	Catégorie:Utilisateur la-1
分類:User la-3	Catégorie:Utilisateur la-3
分類:User la-M	Catégorie:Utilisateur la-M
模板:Distinguish	Modèle:Confusion
模板:Information	Modèle:Information
分類:Huâng-cô̤i	Catégorie:Criminalité
Sáik-mō̤	Phthiraptera
分類:Séng-sék	Catégorie:Science de l'information
分類:Hāi	Catégorie:Mer
Hŭng-siéng	Ventilateur
分類:Guōng-dĕ̤ng	Catégorie:Guangdong
分類:Hók-gióng	Catégorie:Fujian
分類:Ciék-ciĕ dông-ŭk	Catégorie:Arthropode
分類:User nan	Catégorie:Utilisateur zh-min-nan
分類:User nan-1	Catégorie:Utilisateur zh-min-nan-1
分類:User nan-2	Catégorie:Utilisateur zh-min-nan-2
分類:User nan-3	Catégorie:Utilisateur zh-min-nan-3
分類:User nan-M	Catégorie:Utilisateur zh-min-nan-M
分類:Hĭ-ciŭ guók-gă	Catégorie:Pays d'Afrique
分類:Gáuk-guók gì gáu-ṳ̆k	Catégorie:Éducation par pays
Wikipedia:Dŏng-nièng gĭng-dáng/11 nguŏk	Wikipédia:Éphéméride/novembre
模板:User ja-2	Modèle:Utilisateur ja-2
模板:User ja-3	Modèle:Utilisateur ja-3
分類:User vi	Catégorie:Utilisateur vi
分類:User vi-1	Catégorie:Utilisateur vi-1
分類:User vi-2	Catégorie:Utilisateur vi-2
分類:User vi-M	Catégorie:Utilisateur vi-M
分類:Ciék-gŏng	Catégorie:Zhejiang
分類:Ĭng-ngŏk-gă	Catégorie:Musicien
模板:Lang	Modèle:Langue
分類:Hŏk-sŭk	Catégorie:Académie
Bì-bà (ngŏk-ké)	Pipa (instrument)
分類:Wikimedia gĕ̤ng-tiàng	Catégorie:Projet de la Wikimedia Foundation
分類:Gì-lôi	Catégorie:Jeu de stratégie combinatoire abstrait
模板:Infobox Language/family-color	Projet:Charte graphique/Tableau des langues
分類:Ò̤	Catégorie:Rivière
Cūi-siĕng	Nárcisz
模板:User la-2	Modèle:Utilisateur la-2
模板:User no-1	Modèle:Utilisateur no-1
模板:User zh-1	Modèle:Utilisateur zh-1
模板:User zh-2	Modèle:Utilisateur zh-2
模板:User zh-3	Modèle:Utilisateur zh-3
Nùng-mìng-gĕ̤ng	Mingong
分類:Dâi-hàng Mìng-guók ìng-ŭk	Catégorie:Personnalité sud-coréenne
分類:Sôi-diēng ìng-ŭk	Catégorie:Personnalité suédoise
分類:Nĭk-buōng ìng-ŭk	Catégorie:Personnalité japonaise
分類:Dài-uăng ìng-ŭk	Catégorie:Personnalité taïwanaise
分類:User nl	Catégorie:Utilisateur nl
分類:User zh-1	Catégorie:Utilisateur zh-1
分類:User zh-3	Catégorie:Utilisateur zh-3
分類:User zh-2	Catégorie:Utilisateur zh-2
分類:Cāi	Catégorie:Papier
分類:Cáik-ké	Catégorie:Période solaire
分類:Ông-ò̤	Catégorie:Canal
分類:Uŏk-nàng ìng-ŭk	Catégorie:Personnalité vietnamienne
分類:Sóng-dièu huòng-dá̤	Catégorie:Empereur de la dynastie Song
分類:Dòng-dièu huòng-dá̤	Catégorie:Empereur de la dynastie Tang
分類:Mìng-dièu huòng-dá̤	Catégorie:Empereur de la dynastie Ming
分類:Ngò̤-lò̤-sṳ̆ ìng-ŭk	Catégorie:Personnalité russe
分類:Hiŏng-gē̤ng ìng-ŭk	Catégorie:Personnalité hongkongaise
分類:Ciĕk-káik ìng-ŭk	Catégorie:Personnalité tchèque
分類:Tái-guók ìng-ŭk	Catégorie:Personnalité thaïlandaise
Uŏk-ngṳ̄	Cantonais
分類:Sáng	Catégorie:Patronyme
分類:Dièu-siēng Mìng-ciō-ciō-ngiê Ìng-mìng Gê̤ṳng-huò-guók	Catégorie:Corée du Nord
分類:Dṳ̆ng-guók ìng-ŭk	Catégorie:Personnalité chinoise
分類:Dièu-siēng	Catégorie:Corée
分類:Dài-uăng	Catégorie:Taïwan
分類:Dièu-siēng Mìng-ciō-ciō-ngiê Ìng-mìng Gê̤ṳng-huò-guók ìng-ŭk	Catégorie:Personnalité nord-coréenne
分類:Liù-giù-guók	Catégorie:Royaume de Ryūkyū
分類:Hók-gióng-nè̤ng	Catégorie:Naissance dans la province du Fujian
分類:Dâi-iòng-ciŭ guók-gă	Catégorie:Pays d'Océanie
分類:Báe̤k Mī-ciŭ guók-gă	Catégorie:Pays d'Amérique du Nord
分類:Ngṳ̀	Catégorie:Poisson
分類:Cūi-guō	Catégorie:Fruit alimentaire
分類:Niōng-tā̤ dông-ŭk	Catégorie:Mollusque
分類:Só-cê	Catégorie:Numération
分類:Gióng-dé̤ṳk cài-lâiu	Catégorie:Matériau de construction
分類:Dông-ŭk	Catégorie:Animal
分類:Ciáh-tùi dông-ŭk	Catégorie:Vertébré
分類:Ìng-guòng	Catégorie:Droits fondamentaux
分類:Ū-ké	Catégorie:Arme
分類:Nàng Mī-ciŭ guók-gă	Catégorie:Pays d'Amérique du Sud
分類:Gă-sĭ	Catégorie:Ameublement
分類:Ké-chiông	Catégorie:Météorologie
分類:Dṳ̆ng Mī-ciŭ	Catégorie:Amérique centrale
分類:Hiŏng-gē̤ng	Catégorie:Hong Kong
分類:Ĭ-siòng	Catégorie:Vêtement
分類:Cáik-nĭk	Catégorie:Festival
分類:Kuàng-ciék dông-ŭk	Catégorie:Annélide
分類:Bâng	Catégorie:Maladie
分類:Kiŏng-diòng dông-ŭk	Catégorie:Cnidaire
分類:Gùng-dō̤	Catégorie:Archipel
分類:Káh-dièu-nó̤h	Catégorie:Jouet
分類:Gă-dìng	Catégorie:Famille
分類:Dṳ̆ng-guók huòng-dá̤	Catégorie:Empereur de Chine
分類:Huòng-dá̤	Catégorie:Empereur
分類:Chĭng-dièu huòng-dá̤	Catégorie:Empereur de la dynastie Qing
分類:Háng-dièu huòng-dá̤	Catégorie:Empereur de la dynastie Han
分類:Báe̤k Mī-ciŭ	Catégorie:Amérique du Nord
分類:Hù	Catégorie:Lac
分類:Só-hŏk-gă	Catégorie:Mathématicien
模板:Infobox ngṳ̄-ngiòng	Modèle:Infobox Langue
分類:Dâi-iòng-ciŭ	Catégorie:Océanie
分類:Tiĕng-căi	Catégorie:Risque naturel
分類:Gô-dā̤ gì guók-gă	Catégorie:Ancien pays
Vĩnh Long	Province de Vĩnh Long
分類:Dṳ̆ng-huà Ìng-mìng Gê̤ṳng-huò-guók	Catégorie:République populaire de Chine
Cāi-puŏi	Carton ondulé
分類:Giông-kŏng	Catégorie:Santé
分類:Sĕng-lī	Catégorie:Physiologie
分類:Â-muòng	Catégorie:Xiamen
Trojany	Trojany (Mazovie)
模板:Infobox color	Modèle:Infobox Couleur
分類:Ā-ciŭ guók-gă	Catégorie:Pays d'Asie
分類:Mī-ciŭ guók-gă	Catégorie:Pays d'Amérique
模板:User nan-2	Modèle:Utilisateur zh-min-nan-2
模板:User la	Modèle:Utilisateur la
分類:Ŭng-ciŭ	Catégorie:Wenzhou
分類:Huák-lŭk	Catégorie:Loi
分類:Káh-gă	Catégorie:Hakka
分類:Bēng-guòng	Catégorie:Droit d'auteur
分類:Biēu-cìng	Catégorie:Expression faciale
分類:Hók-ciŭ	Catégorie:Fuzhou
分類:Ôi-sĕng	Catégorie:Hygiène
分類:Ciòng-ciŭ	Catégorie:Quanzhou
分類:Dṳ̆ng-huà Mìng-guók	Catégorie:République de Chine
分類:User cdo	Catégorie:Utilisateur cdo
分類:User cdo-M	Catégorie:Utilisateur cdo-M
模板:Image label begin	Modèle:Image label début
模板:Dṳ̆ng-huà Mìng-guók Hèng-céng-kṳ̆	Modèle:Palette Administration territoriale de Taïwan
分類:Sĕng-uăk	Catégorie:Vie quotidienne
分類:User cdo-1	Catégorie:Utilisateur cdo-1
分類:User cdo-2	Catégorie:Utilisateur cdo-2
分類:User cdo-3	Catégorie:Utilisateur cdo-3
Uòng-pŭng	Guêpe
模板:User vi	Modèle:Utilisateur vi
分類:User en-1	Catégorie:Utilisateur en-1
分類:User de-1	Catégorie:Utilisateur de-1
分類:Gă-sĭ-huă	Catégorie:Outil
Lăk-dâi-cé-liŏk Siông	Premier livre des Chroniques
Mìng-kiŏk	Opéra de Min
Wikipedia:失效鏈接	Projet:Correction des liens externes
Liù-giù	Îles Ryūkyū
模板:User nan-3	Modèle:Utilisateur zh-min-nan-3
模板:User wuu	Modèle:Utilisateur wuu
Ngù-nèng	Lait de vache
Hāi-chái	Saccharina japonica
Gŭng-ô-nguòng	Fonction publique
Hù-diĕk	Rhopalocères
模板:Hók-gióng	Modèle:Palette Fujian
Chái-tàu	Radis
分類:Buò-dièng	Catégorie:Putian
模板:Ping	Modèle:Notif
Yun Hyon-seok	Yun Hyon-seok
模板:Ruby	Modèle:Ruby
模組:Arguments	Module:Arguments
特殊:最近其改變	Spécial:Modifications récentes
模組:Citation/CS1	Module:Biblio
模組:TableTools	Module:TableTools
模組:Coordinates	Module:Coordinates
模組:Math	Module:Math
模組:Infobox	Module:Infobox
Ciá	Saccharum
