Naakaii Łizhiní Bikéyah	Afrique
Binaʼadaałtzózí Dinéʼiʼ Bikéyah	Japon
Bitsiighaʼ Łichííʼí Bikéyah	Irlande (pays)
Hángewii	Hongrie
Dibé Diníí Bikéyah	Espagne
Wááshindoon Bikéyah Ałhidadiidzooígíí	États-Unis
Bélgii Bikéyah	Belgique
Látsębooʼ	Luxembourg (pays)
Yágháhookáán	Univers
Nahasdzáán	Terre
Nahoditsʼǫʼłání	Finlande
Déinish Dineʼé Bikéyah	Danemark
Póolish Dineʼé Bikéyah	Pologne
Łitʼoowę́ęya	Lituanie
Ídelii	Italie
Swis Bikéyah	Suisse
Óóswiya	Autriche
Gwíík Dineʼé Bikéyah	Grèce
Tʼóok Bikéyah	Turquie
Béésh Bichʼahníí Bikéyah	Europe
(*@@@u0026asia")	Asie
Shádiʼááhjí kéyah yistinígíí	Antarctique
Kéyah Wóyahgo Siʼánígíí	Pays-Bas
Béésh bee akʼeʼelchíhí tʼáá bí nitsékeesígíí	Ordinateur
Hastiin alą́ąjįʼ dahsidáhígíí Barack Obama	Barack Obama
Táłtłʼááh Chʼosh Bitooh (Kéyah Dah Siʼánígíí)	Uruguay
Bilasáana	Pomme
Méhigo	Mexique
Akééháshį́į́h Hahoodzo	Californie
Máaz	Mars (planète)
Kénya	Kenya
Iithiyópya	Éthiopie
Gáana	Ghana
Náshdóítsoh bitsiijįʼ daditłʼooígíí	Lion
Dáághahii Dinéʼiʼ Bikéyah	France
Łééchąąʼí	Chien
Tótaʼ Dinéʼiʼ Bikéyah	Royaume-Uni
Mósí	Chat
Dáághahii bizaad	Français
Łóóʼ	Poisson
Bwazííl	Brésil
Biʼééʼ Łichííʼí Bikéyah	Russie
Łóóʼtsoh dóó Tééh hóyáanii	Cetacea
Naakaii bichʼil łitsxooí	Mangue
Élábéemah Hahoodzo	Alabama
Béésh Bichʼahii Bikéyah	Allemagne
Bééshbichʼahii bizaad	Allemand
Tin Bikéyah	Islande
Ééstii Bikéyah	Estonie
Séetin	Saturne (planète)
Didzéchííʼ	Cerise
Chidí naatʼaʼí	Avion
Hastiin alą́ąjįʼ dahsidáhígíí George W. Bush	George W. Bush
Létbiiya	Lettonie
Yóókwein	Ukraine
Chek Bikéyah	République tchèque
Słóbaʼ Bikéyah	Slovaquie
Słobíín Bikéyah	Slovénie
Wooméiniya	Roumanie
Bálgaa Bikéyah	Bulgarie
Dziłigaii Bikéyah	Albanie
Haʼaʼaahjí Hakʼaz Dineʼé Bikéyah	Groenland
Kwóóʼad Bikéyah	Croatie
Bosna dóó Hetsog Bikéyah	Bosnie-Herzégovine
Azééwii Bikéyah	Azerbaïdjan
Andówa	Andorre
Béésh Łichíiʼii Bikéyah	Chypre (pays)
Jóojah (Kéyah)	Géorgie (pays)
Kʼazah Bikéyah	Kazakhstan
Dziłizhin Bikéyah	Monténégro
Bádikin Sídii	Vatican
San Mawínoo Bikéyah	Saint-Marin
Kyóoba	Cuba
Hashkʼaan Bikéyah	Barbade
Indoníízha	Indonésie
Tʼóok bizaad	Turc
Kéyah Naakai Łizhinii Bikéyah Shádiʼááhjí Siʼánígíí	Afrique du Sud
Aljííya	Algérie
Ózbeʼ Bikéyah	Ouzbékistan
Tó	Eau
Níłchʼi naalkidí	Télévision
Chíilii	Chili
Doodaatsaahii (Jíísas)	Jésus-Christ
Mókiwii	Mercure (planète)
Ákáʼátʼįįł (béésh ntsékeesígíí álʼíní)	Apple
Biinis	Vénus (planète)
Jíbitoo	Jupiter (planète)
Yoowéinis	Uranus (planète)
Néʼtoon	Neptune (planète)
Sį́ʼgaboo	Singapour
Tłóotoo	Pluton (planète naine)
Łííhtensain	Liechtenstein
Dágháilchįįh	Adolf Hitler
Naaltsoos biniiʼ	Facebook
Naaki góneʼ yéigo daʼahijoogą́ą́ʼ	Seconde Guerre mondiale
Ałhíʼayiiltááh	Mathématiques
Aooméénii Bikéyah	Arménie
Ooljééʼ	Lune
Nahatʼeʼiitsoh Bikéyah	Australie
Béésh Łigaii Bikéyah	Argentine
Kolíya Bikéyah Náhookǫsjí Siʼánígíí	Corée du Nord
Naayééʼ	Dinosaure
Bilasáana bitseeʼ nineezígíí	Pyrus
Naturalis Historia of Pliny the Elder	Histoire naturelle (Pline l'Ancien)
Encyclopædia Britannica	Encyclopædia Britannica
Tó yaʼnidaʼaazgééd	Aqueduc
Chʼil łitsooí díkʼǫ́zhígíí	Citron
Hashkʼaan (łitsooígíí)	Banane
Sǫʼ	Étoile
Jóhonaaʼéí	Soleil
Háájiʼjin	Hydrogène
Níłchʼi Ászólí	Hélium
Haʼaʼaahjí Tíímow	Timor oriental
Séwes	(1) Cérès
Haʼooméya	(136108) Hauméa
Maakiimaakii	(136472) Makémaké
Ééwis	(136199) Éris
Káábin	Carbone
Níłchʼi Yáʼátʼéehii	Oxygène
Hadoh dóó hakʼaz neiłkidígíí	Thermomètre
Níłchʼi Łitsxooí	Néon
Chihuahua Hahoodzo	État de Chihuahua
Soodin	Sodium
Béésh Łikoní	Magnésium
Béésh Ászólí	Aluminium
Tó Wónaanídę́ę́ʼ Bitsįʼ Yishtłizhii Bikéyah	Inde
Tʼoobááloo	Tuvalu
Béésh (Fe)	Fer
Tʼónga	Tonga
Łeetsoii	Soufre
Samóa	Samoa
Sólomon Tó Bináhaazyínígíí	Salomon (pays)
Banoʼáátʼoo	Vanuatu
Páápowa Bigíní Ániidí	Papouasie-Nouvelle-Guinée
Níłchʼi Dootłʼizhí	Argon
Eʼeʼaahjí Tónteel bikáaʼgi Kéyah Yázhí dah Ndaaʼeełgo Ałhidadiidzooígíí	Micronésie (pays)
Káálsiiyin	Calcium
Dilyį́hí	Plomb
Kílíbas	Kiribati
Chʼah Diʼilii Bikéyah	Mongolie
Fííjii	Fidji
Béésh doo Ńdiniichxíihii	Titane
Táłkááʼ Bighan Dineʼé Bikéyah	Venezuela
Méíin Hahoodzo	Maine (État)
Łį́į́ʼ	Cheval
Naaldeehii	Animal
Sówinam	Suriname
Kéyah Nahasdzáán Ałníiʼgi Siʼánígíí	Équateur (pays)
Kolámbiya	Colombie
Béésh Łibáhí	Cobalt
Bolíbiya	Bolivie
Béésh Łichíiʼii	Cuivre
Niihémpshoo Hahoodzo	New Hampshire
Chʼosh doo yitʼíinii dláádí dóó Ábishjaaʼ	Fungi
Jaméíkʼa	Jamaïque
Méésíchóoshish Hahoodzo	Massachusetts
Kanédikiʼ Hahoodzo	Connecticut
Naaʼahóóhai	Gallus gallus domesticus
Antíígwa dóó Hashkʼaan Bikéyah Yázhí	Antigua-et-Barbuda
Kéyah Ałkéé Nitį́įgo Dah Ndaaʼeełí	Hawaï
Damóo Bikéyah	Dominique (pays)
Domingo Bikéyah	République dominicaine
Bisóodi	Porc
Héítii	Haïti
Iiwą́ą́	Iran
Iiwááʼ	Irak
Hakʼaz Dineʼé Bikéyah Hahoodzo	Alaska
Ízrel Bikéyah	Israël
Shádiʼááhjí Ásáí Bikéyah	Yémen
Jóoʼdan	Jordanie
Gah Bikeeʼ Taahíʼahí	Floride
Kíígiz Bikéyah	Kirghizistan
Hoozdo Hahoodzo	Arizona
Kóóweiʼ	Koweït
Lááʼos	Laos
Łíbanoo	Liban
Óogin Hahoodzo	Oregon
Naakaii Dootłʼizhí Bikéyah Yázhí (Tó Bináhaazyínígíí)	Maldives
Kéyah dah siʼánígíí	Amérique
Áshįįh Biiʼtó Hahoodzo	Utah
Béégashii	Bos taurus
Maléízha	Malaisie
Dziłgaiitsoh Honeezkʼazii Bikéyah	Népal
Omą́ą́	Oman
Eʼeʼaahjí Naakaii Dootłʼizhí Bikéyah	Pakistan
Kʼatár	Qatar
Ásáí Bikéyah Saʼoodí	Arabie saoudite
Swii Lankʼa	Sri Lanka
Sííwiya	Syrie
Tʼajiʼ Bikéyah	Tadjikistan
Tʼáí Bikéyah	Thaïlande
Kǫʼ naʼałbąąsii diné bee nágéhéʼ	Train
Tʼóokmen Bikéyah	Turkménistan
Ásáí Bikéyah Yázhí Ałhidadiidzooígíí	Émirats arabes unis
Biʼednam	Viêt Nam
Kolíya Bikéyah Shádiʼááhjí Siʼánígíí	Corée du Sud
Óola	Or
Naʼałkaahí	Scientifique
Bangla Bikéyah	Bangladesh
Angóola	Angola
Iiʼniʼ Tłʼiishtsoh Bikéyah	Bhoutan
Bwoonéí	Brunei
Tʼanzanííya	Tanzanie
Béésh Tózháanii	Mercure (chimie)
Kéyah Dańlíinii	Philippines
Naakaii Łizhinii Bikéyah Beʼałnííʼ	République centrafricaine
Hastiin Albert Einstein	Albert Einstein
Tʼóogo	Togo
Hooghan Tsé Bee Ádaalyaaí Bikéyah	Zimbabwe
Shádiʼááhjí Soodą́ą	Soudan du Sud
Tswana Dineʼé Bikéyah	Botswana
Wóndii Dineʼé Bikéyah	Burundi
Ooljééʼ Bikéyah Yázhí	Comores (pays)
Kéyah Káango Náhookǫsjí Siʼánígíí	République du Congo
Kéyah Káango Shádiʼááhjí Siʼánígíí	République démocratique du Congo
Jibótii	Djibouti
Gíní Nahasdzáán Ałníiʼgi Siʼánígíí	Guinée équatoriale
Gabǫ́ǫ́ (Kéyah)	Gabon
Géémbiya	Gambie
Gíní	Guinée
Gíní Bisó	Guinée-Bissau
Chį́į́h Yee Adilohii Bideeʼ Tónteel Bibąąh	Côte d'Ivoire
Táłtłʼááh Chʼosh Daadánígíí Bitooh (Łizhinii Bikéyahdi)	Cameroun
Tónteel Bibąąh Dootłʼizhí	Cap-Vert
Sotho Dineʼé Bikéyah	Lesotho
Łíbya	Libye
Madaʼgéésgáá	Madagascar
Malááwii	Malawi
Moowitéínya	Mauritanie
Moroko	Maroc
Namííbya	Namibie
Yogénda	Ouganda
Wánda Dineʼé Bikéyah	Rwanda
Seishel	Seychelles
Náshdóítsoh Bitsiijįʼ Daditłʼooʼígíí Bidził	Sierra Leone
Soomáálii Bikéyah	Somalie
Soodą́ą	Soudan
Swáazi Dineʼé Bikéyah	Swaziland
Nahasdzáán Bikáaʼgi Kéyah Naaznilgo Ałhidadiidzooígíí	Organisation des Nations unies
Nidaashchʼąąʼígíí	Couleur
Béésh Łigaii	Argent
Béésh Dildǫʼí	Étain
Łéétsoh	Uranium
Hastiin alą́ąjįʼ dahsidáhígíí Bill Clinton	Bill Clinton
Míshigin Hahoodzo	Michigan
Tó Nitsaa Nílį́bąąh Hahoodzo	Illinois
Náhookǫsjí Dzígaii	Dakota du Nord
Ałnííʼjí Dzígaii	Dakota du Sud
Ayání Naakaii Hahoodzo	Montana
Tóʼííbézhí	Wyoming
Nímasii Kʼidadilyéhé	Idaho
Ahééhałtį́į́h Hahoodzo	Washington (État)
Naʼazhǫǫsh Hahoodzo	Nevada
Kayíbíyinsíí (tónteel)	Mer des Caraïbes
Dibé Nitsaa Hahoodzo	Colorado
Naakaii bizaad	Espagnol
Naʼashjéʼii	Araneae
Chʼosh bijáád tseebíhígíí	Arachnida
Chʼosh bideeʼ ádaadinígíí	Chelicerata
Chʼosh bijáád dahólónígíí	Arthropode
Béeso	Monnaie
Bijíniyah Hahoodzo	Virginie (État)
Eʼeʼaahjí Bijiniyah Hahoodzo	Virginie-Occidentale
Kin Yótʼááh Deezʼá Hahoodzo	État de New York
Wóód Áalin Hahoodzo	Rhode Island
Chʼosh bijáád hastání	Insecte
Méelin Hahoodzo	Maryland
Déláwee Hahoodzo	Delaware
Oohááyoo Hahoodzo	Ohio
Pénsówéíniyah Hahoodzo	Pennsylvanie
Niijéízii Hahoodzo	New Jersey
Índíʼyéenah Hahoodzo	Indiana
Chidí	Automobile
Jóojah Hahoodzo	Géorgie (États-Unis)
Akałii Bikéyah	Texas
Náhookǫsjí Kééláanah Hahoodzo	Caroline du Nord
Shádiʼááhjí Kééláanah Hahoodzo	Caroline du Sud
Méhigoʼ sídii	Mexico
Bilasáana diwozhí	Ananas
Mísísípii Hahoodzo	Mississippi (État)
Ténésii Hahoodzo	Tennessee
Yootó Hahoodzo	Nouveau-Mexique
Mínisóodah Hahoodzo	Minnesota
Wiskaansin Hahoodzo	Wisconsin
Haʼaʼaahjí Dzígaii	Iowa
Nabeeskah Hahoodzo	Nebraska
Shádiʼááhjí Dzígaii	Kansas
Tó Dzígaii Nílį́	Missouri (État)
Tónteel Chʼínílį́	Louisiane
Kentákii Hahoodzo	Kentucky
Dził Biiʼ Dzígaii	Arkansas
Halgai Hóteel Hahoodzo	Oklahoma
Ho Chi Min Sídii	Hô-Chi-Minh-Ville
Bilagáana bizaad	Anglais
Náhookǫsjí Hakʼaz Dineʼé Bikéyah	Nunavut
1901 – 1950	1902
Tłʼiish	Serpentes
1951 – 2000	1979
Pope Benedict XVI	Benoît XVI
Maʼii Ashkii	Geronimo
Tsin naaʼeeł táłtłʼááh naagháhígíí	Sous-marin
Tahoniigááh	Grippe
Tłʼízí	Chèvre
Kǫʼ	Feu
Tʼááłáhági átʼéego:Templates	Catégorie:Espace Modèle
Dloziłchííʼ	Écureuil roux
Tʼááłáhági átʼéego:Bideeʼtsʼinígíí	Catégorie:Bovidae
Tʼááłáhági átʼéego:Ndaaʼnaʼii	Catégorie:Squamate
Tiníléítsoh	Dragon de Komodo
Chʼosh bijáád neeznánígíí	Decapoda
Aymara bizaad	Aymara
Łeeyiʼ chʼoshtsoh binááʼ hólónígíí	Gymnophiona
Tʼááłáhági átʼéego:Dééł dóó Tóidoozohii	Catégorie:Gruiformes
Médíwííyin Sii	Mer Méditerranée
Jóojah (Ałtsʼáʼáztiin)	Georgia
Alóós	Riz
Tsídii	Oiseau
Kéłánii bikágí yilzhólígíí	Onychophora
Kéchwa bizaad	Quechua
Ínsadoobíídiiya	Encyclopédie
Íiyisíí Naaltsoos	Wikipédia:Accueil principal
Dziłgaiitsoh Honeezkʼazii	Himalaya
Tʼááłáhági átʼéego:Candidates for speedy deletion	Catégorie:Wikipédia:Suppression immédiate demandée
Chʼil ahwééh	Thé
Adijiłii	Erinaceinae
Kéyah Sahééwa Eʼeʼaahjí Siʼánígíí	Sahara occidental
1801 – 1850	1815
Łį́į́ʼ Bideeʼłáaʼii	Licorne
Hastiin Hernán Cortés	Hernán Cortés
Tsʼíʼii daʼaneezí	Culicidae
Dibé	Mouton
Łóóʼ hashkéhé	Requin
Ghą́ą́ʼaskʼidii	Camelus
Bidił Daazdoígíí dóó Daʼałtʼoʼígíí	Mammifère
Bíchį́į́h yee adilohii	Éléphant
Mágí dóó Mágí Ndahalinígíí	Primates
(*wálá-)	Fourmi
Tsísʼná	Abeille
Naayízítsʼósí	Courgette
Jiłtʼoʼí	Rheum rhabarbarum
Sęęschʼil	Chou-fleur
Ayęęzhii yiltʼąąʼí	Aubergine
Naalʼeełí	Anatidae
Yas	Neige
Jádí dághaaʼígíí	Gnou
1851 – 1900	1865
Biʼééʼ Łichííʼí bizaad	Russe
1751 – 1800	1784
Bááh	Pain
Bee Hazʼą́ą Ił Chʼétʼaah	Déclaration universelle des droits de l'homme
Kéyah haʼdéísná	Séisme
Tó nitéél nitságoʼ atságáá	Tsunami
Níyoltsoh	Tornade
Saad bee alʼį́į́hni	Système d'écriture
Tʼááłáhági átʼéego:Dáághahii	Catégorie:France
Mąʼii łitsooí	Renard roux
Naaltéʼ	Esclavage
Ahwééh	Café
Abeʼ	Lait
Dził	Montagne
Doo Nidahałtingóó	Désert
Cryptographic	Cryptographie
Guadalajara	Guadalajara (Mexique)
Tsídii naʼałkʼaiʼí	Manchot
Kolíya Dineʼé bizaad	Coréen
Gah	Lapin
Tó niteel	Océan
Hodíłchʼil Níłtsánígíí	Forêt humide
HiTSʼezh	IPod
Hazéí	Sciuridae
Hazéí naatʼáʼii	Pteromyinae
Ééʼ néíshoodí	Église catholique
Kwį́į́n Elizabeth II	Élisabeth II
Hastiin alą́ąjįʼ dahsidáhígíí Ronald Reagan	Ronald Reagan
Hastiin Emperor Yongle	Ming Yongle
Naʼashjéʼiitsoh	Lycosidae
Naaldlooshii dadichʼízhii	Reptile
Tsin Deigházhígíí	Rodentia
Hasbídí	Columbidae
Tééh hóyáanii	Phocoenidae
Biyáázh Tsʼǫʼasánígíí (Táyiʼ dóó Niʼkáágóó Ndaakaaígíí)	Amphibia
Géeso	Fromage
Chʼil naʼatłʼoʼii (chʼiyáán)	Raisin
Tsísʼná bitłʼizh	Miel
Atsįʼ	Viande
Naʼashjéʼii tsiizisí	Pholcidae
Nímasii	Pomme de terre
Áshįįh łikan	Sucre
Haʼałtsédii	Fruit à coque
Wááshindoon bisiláołtsooí	Forces armées des États-Unis
Naʼiiniʼ bá Hooghantsoh	World Trade Center
Áshįįh	Sel alimentaire
Wááshindoondi bee hazʼáanii ádeiłʼíní	Congrès des États-Unis
Tsin naaʼeeł	Navire
Nidaʼąnyéézh	Irrigation
Naadą́ą́ʼ	Maïs
Naʼashchʼąąʼ	Peinture
Wótáahgoo ałnaaʼáłtʼahiʼ	Astronaute
Azhish	Danse
Naʼashjéʼii nahachaʼígíí	Salticidae
Kéyah Daʼnaaznilígíí	Liste des pays du monde
Shash	Ursidae
Hastiin alą́ąjįʼ dahsidáhígíí John Adams	John Adams (homme politique)
Hastiin alą́ąjįʼ dahsidáhígíí Thomas Jefferson	Thomas Jefferson
Hastiin alą́ąjįʼ dahsidáhígíí Andrew Jackson	Andrew Jackson
Ńdíshchííʼ	Pin (plante)
Tłʼoh naadą́ą́ʼ	Blé
Naałniih yichʼą́ą́h naabaahígíí bąąh dahooʼaahgo	Syndrome d'immunodéficience acquise
Abeʼ bee neezmasí	Crêpe
Jéíʼádįįh	Tuberculose
Łóódtsoh	Variole
Zelda bahaneʼ	The Legend of Zelda (série)
Naakáí dinéʼiʼ biempire Méhigodi	Aztèques
Łéétsoh bee atsiniltłʼish álʼį́	Énergie nucléaire
Łéétsoh beeʼeldǫǫhtsoh beeʼalį́į́h	Arme nucléaire
Chidí naaʼnaʼí beeʼeldǫǫh bikááʼ dah naaznilígíí	Char de combat
Dah woozh	Fragaria ×ananassa
Jalisco Hahoodzo	Jalisco
Dzidzé łikaní dootłʼizhígíí	Bleuet (fruit)
Dzidzé łikaní dinilchííʼígíí	Framboise
Mágí bichʼiyąʼ	Cocos nucifera
Dzidzétsoh	Pêcher
Chʼil łitsxooí	Orange (fruit)
Chʼil dishooí	Kiwi
Chʼil dootłʼizhí díkʼǫ́zhígíí	Lime (fruit)
Abeʼ yistiní	Crème glacée
Méhigo bizaad	Nahuatl
Diné bizaad	Navajo (langue)
Jeeʼiighááh	Dermaptera
Tenochtitlan	Mexico-Tenochtitlan
Ásáí Bizaad	Arabe
Honeezílígi	Zone subtropicale
Atʼaʼ yiltʼąąʼí	Arecaceae
Niłchiis	Gulo gulo
Tsin yilátah ayání	Girafe
Naalʼeełídaaʼí	Ornithorynque
Naʼashǫ́ʼii	Lacertilia
Béésh bee akʼeʼelchí áłtsisígíí	Ordinateur personnel
Wikiibíídiiya:Naaltsoos nizhónígo ádaalyaaígíí	Wikipédia:Articles de qualité
Bimááʼ Hahoodzo	Vermont
Hoozdoh	Phoenix (Arizona)
Tʼáyaałchííʼ	Pic flamboyant
Táłkááʼ tsʼin bíchį́į́hnézí	Gavial du Gange
Tsin naaʼeeł chidí naatʼaʼí bee nágéhéʼ	Porte-avions
Tsídiitsoh	Autruche d'Afrique
Kolíya bikéyah (Ałtsʼáʼáztiin)	Corée
Mąʼiitsoh	Canis lupus
Chʼídeeldlóohiitsoh	Bec-en-sabot du Nil
Hodíłchʼilgi dlǫ́ʼiitsoh	Paradoxurus hermaphroditus
Tóidoozohii bidaaʼ łichííʼígíí	Gallinule poule-d'eau
Táłtłʼááh yilcháazhii	Porifera
Tónteel naʼashjéʼii	Pycnogonida
Séigoʼ bíláshgaanézí	Amblypygi
Naʼashjéʼii jáádnézí	Opiliones
Séigoʼchilí bitseeʼ ádinígíí	Pseudoscorpionida
Séigoʼ	Scorpiones
Zahalchíʼii	Solifugae
Hastiin Emperor Qianlong	Qianlong
Séigoʼ bitseeʼ áłtsʼózígíí	Uropygi
Yaaʼ doo yitʼíinii	Acari
Hodíłchʼilgi naaʼahóóhai	Tinamiformes
Tłʼiishkʼosí (tsídii)	Anhingidae
Télii	Âne commun
Náshdóítsoh noodǫ́zígíí	Tigre
Kʼíneeshbízhiinééz	Spaghetti
Chʼosh yoołgai bitsʼaʼígíí	Ostreidae
Tábąąhgi łeeyiʼ chʼosh	Arenicola marina
Azeeʼ hókániitsoh	Cirse commun
Táłkáaʼgi Tsídii	Anseriformes
Tązhii dóó Naaʼahóóhai Ndahalinígíí	Galliformes
Naalʼeełii keelóól	Podicipediformes
Tsídii Deílʼésígíí	Ciconiiformes
Daʼałtʼoʼígíí Biyęęzhii Deiłchíhígíí	Monotremata
Adijiłii bíchį́į́hnézí	Échidné
Biyázhí neiyéhé	Didelphidae
Hazéítsʼósii	Tamia
Chidí bikʼah	Pétrole
Chéłchaaʼ	Coleoptera
Łį́į́ʼ ałchiní	Cheval de Przewalski
Dlǫ́ʼii yił aheełtʼéhii noodǫ́zígíí	Mangouste rayée
Naʼastsʼǫǫsíʼniiʼí	Peramelidae
Shash naʼazísí	Vombatidae
Nahatʼeʼiitsohchilí	Potoroidae
Náʼagéédí łichíiʼii	Chrysochloridae
Bįįh Danilínígíí	Cervidae
Tin	Glace
Tłʼohchin díchʼííʼí	Ail cultivé
Taʼneeskʼání áłtsʼóózígíí	Concombre
Tłʼohchin (chʼil daadánígíí)	Oignon
Chʼil łichxíʼí	Tomate
Béésh Łichíiʼii Bikéyah Náhookǫsjígo Siʼanígíí	Chypre du Nord
Naʼazhǫǫsh Hátsoh	Las Vegas
Náshdóí dilwoʼí	Guépard
Tsékǫʼ	Charbon
Néʼéshjaaʼ	Strigiformes
Bíígháán Dahólónígíí	Vertébrés
Kʼishchííʼ	Bouleau
Ǫǫbǫʼii	Huppe fasciée
Náshdóí Ndahalinígíí	Felidae
Yádiłhił yiiyídíʼ nahosdzáán yináádáłiʼ	Station spatiale internationale
Tó wónaanídę́ę́ʼ toohjįʼ noołnahii	Héron cendré
Hashkʼaan dijéʼé	Phoenix dactylifera
Wááshindoon (Ałtsʼáʼáztiin)	Washington
Bidił Daazdoígíí dóó Daʼalghałígíí	Carnivora
Chʼoshtsoh	Blattaria
Dlǫ́ʼii yázhí	Belette
Tsʼíʼii dóó Tséʼédǫ́ʼii	Diptera
Biniiʼłigaii (néʼéshjaaʼ)	Chouette effraie
Mąʼii Ndahalinígíí	Canidae
Bijáád Ádaadinígíí	Mollusca
Chʼosh łitsxooí dóó Chʼosh łichííʼí	Coccinellidae
Táłkááʼ naalzheehí	Balbuzard pêcheur
Bizaʼazis Dahólónígíí	Marsupialia
Dlǫ́ʼiiłgaii	Hermine
Naalʼeełí bitsiiʼ dootłʼizhí	Canard colvert
Sǫʼ łóóʼ	Étoile de mer
Giníłbáhí	Autour des palombes
Tʼádootłʼizhii	Geai des chênes
Zhį́ʼii	Grand Corbeau
Táłkááʼ tsʼin Danilínígíí	Crocodilia
Chʼosh bikágí dantłʼizí	Crustacé
Dééł	Gruidae
Chʼosh bitsʼaʼígíí	Bivalvia
Atsá dóó Giní Ndahalinígíí	Falconiformes
Łóóʼ ooshgę́ęzhii	Chondrichthyes
Tániilʼáí	Odonata
Wóláchííʼ yildeełí bikágí ntłʼizí	Pangolin
Gah Danilínígíí	Lagomorpha
Tsísʼnátsoh	Bombus
Hazéí yiltseeʼí	Achillée millefeuille
Chʼosh bikǫʼí	Lampyridae
Zéédzísgaii	Faisan de Colchide
Dlǫ́ʼii Ndahalinígíí	Mustelidae
Tsin yiłkaałii	Picidae
Bideeʼtsʼinígíí	Bovidae
Dééł dóó Tóidoozohii Ndahalinígíí	Gruiformes
Gáagii dóó Joogii Ndahalinígíí	Corvidae
Chʼiltaatʼagii	Busard Saint-Martin
Tsin naaʼeeł diné bee nágéhéʼ	Ferry (bateau)
Gad	Genévrier
Jááłánii	Myriapoda
Biishchʼid Dahólónígíí	Placentalia
Chʼosh Deildeełii	Insectivora
Tó wónaanídę́ę́ʼ naalʼeełítsoh łibáhígíí	Oie cendrée
Tónteel dóó Tábąąhgi Tsídii	Charadriiformes
Ńdíshchíitah dlǫ́ʼii	Martre des pins
Biyaatsʼiin Dahólónígíí	Gnathostomata (Vertebrata)
Tooh łéʼétsoh	Rat musqué
Chaatʼíní	Oseille commune
Łóóʼ hashkéhé dootłʼizhígíí	Requin bleu
Wóʼatsʼǫǫsii Ádaatʼéhígíí	Hemiptera
Atsáłgaii	Buse pattue
Béégashiiʼilí	Yak
Tó wónaanídę́ę́ʼ dlǫ́ʼii	Mustela putorius
Tsxį́į́łnaalkʼįhii	Apodidae
Dziłditłʼoii Bił Hahoodzo	Comté de San Juan (Utah)
Hakʼaz naalʼeełí	Eider à duvet
Naalʼeełítsoh bitsiiʼ halzhinígíí	Bernache du Canada
Chʼó	Picea
Łóóʼtsoh łizhin dóó łigaígíí	Orque
Jáádtsʼósí	Recurvirostridae
Téél dzítsooii dóó Tsétah chʼosh	Carabidae
Naalʼeełítsoh diłhiłígíí	Bernache cravant
Tábąąh dlǫ́ʼii	Vison d'Amérique
Dlǫ́ʼii bitéél halgaií	Fouine
Tábąąstííntsoh łibáhígíí	Phoque gris
Naakaii Łizhiní Bikéyahdi Hadahóólįįdígíí	Afrotheria
Diné Nááhódlóonii bizaad	Langues athapascanes
Łį́į́ʼ bitsísʼná	Oestridae
Tónteel tsídii	Laridae
Ałtį́į́ jikʼáshí (chʼil)	Equisetum
Hazaʼaleehtsoh (dííshjį́ ááłjiní)	Céleri
Kʼaalógii dóó Iichʼąhii	Lepidoptera
Díłdánii yił aheełtʼéhii	Caille des blés
Chʼałdą́ą́ʼ / Jádí nátʼoh (chʼil daadánígíí)	Asperge
Tséʼédǫ́ʼii dootłʼizhí	Calliphoridae
Jaaʼabaní Danilínígíí	Chiroptera
Wóónałchídii	Elateridae
Tsídii bidaanézí	Cigogne
Dlǫ́ʼii	Mustela
Lókʼaaʼ	Roseau commun
Tsídiiłbáhí	Passeridae
Biłʼeʼeliníʼ	Levure chimique
Táłtłʼááh chʼoshchilí	Euphausiacea
Tsiiʼyiishbizhí Dinéʼiʼ Bikéyah	Monde chinois
Naalʼeełí binááʼ łitsooígíí	Garrot à œil d'or
Tábąąstíín	Loutre d'Europe
Jélii łóóʼ	Méduse (animal)
Náshdóíłgaii łikizhígíí	Once (félin)
Tábąąstííntsoh Danilínígíí	Pinnipède
Dlǫ́ǫ́ʼ	Chien de prairie
Náshdóí bijaałizhiní	Caracal
Chʼóhojilyééh	Datura stramonium
Chʼah Diʼilii Bikéyahdę́ę́ʼ naalʼeełítsoh	Oie cygnoïde
Tsídii yáłtiʼí	Psittaciformes
Tééh łį́į́ʼ	Zèbre
Náshdóí łikizhígíí	Ocelot
Dííłdzid jeeshóóʼ	Percnoptère
Tʼáadoo leʼé danílʼį́ bił hazʼą́	Musée
Shash łizhin dóó łigaígíí	Panda géant
Shash łigaígíí	Ours blanc
Gaantsʼosí	Crinoidea
Hastiin alą́ąjįʼ dahsidáhígíí Theodore Roosevelt	Theodore Roosevelt
Neeshchʼííłgai	Anacardier
Beeʼódleehí	Piégeage animal
Dilní bee Nidaʼanéhígíí	Instrument de musique
Dééłgai	Cygne
Bikááʼ náʼoobałí	Hélicoptère
Dziʼizítsoh	Motocyclette
Tééhoołtsódii	Hippopotamus amphibius
Séí	Sable
Naakaii Łizhiní Bikéyahdę́ę́ʼ náshdóítsoh łikizhígíí	Léopard
Déélgééd	Rhinocéros
Beeʼeldííl Dahsinil	Albuquerque
Hashkʼaan dootłʼizhí (babáayah)	Papayer
Chʼil łigaii (atʼééké bijish)	Chou cabus
Náshdóítsoh	Puma
Ásáí dinéʼiʼ	Arabes
Deeteel	Alces alces
Shádiʼááhdę́ę́ʼ náshdóítsoh łikizhígíí	Jaguar
Lókʼaatsoh	Bambou
Káango (Ałtsʼáʼáztiin)	Congo
Kʼaiʼ	Saule
Shash bizaʼazis hólóní	Koala
Náshdóí kʼos bee naashchʼąąʼígíí	Panthère nébuleuse
Shashtsoh	Ours brun
Łéʼétsoh	Rattus
Akʼáán	Farine
Mágítsoh	Gorille
Bitsįʼ yishtłizhii	Amérindiens
Dáʼákaz łikaní	Canne à sucre
Chʼil akʼahí	Avocatier
Neeshchʼííłbáhí	Arachide
Dzidzétsoh díkʼǫ́ǫzhii	Abricotier
Naʼashǫ́ʼii łahgo ánééhé	Chamaeleonidae
Yootó	Santa Fe (Nouveau-Mexique)
Łééchąąłgaii	Lévrier greyhound
Nahatʼeʼiitsoh Bikéyahdę́ę́ʼ łééchąąʼí ałchiní	Dingo (chien sauvage)
Chʼééhjiyáán	Pastèque
Teide	Teide
Naʼastsʼǫǫsí	Mus (genre)
Hakʼaz bįįh	Rangifer tarandus
Chʼosh doo yitʼínii	Micro-organisme
Táshchozhii	Hirundinidae
Neeshchʼííʼ hááheeshchiiʼí	Amandier
Łóóʼ bigaan tseebíí	Octopoda
Chʼosh bikágí ntłʼizí	Brachyura
Tábąąstííntsoh bideeʼ hólónígíí	Morse (animal)
Mágí diʼilí	Orang-outan
Atsátsoh	Aigle royal
Łóóʼtʼą́hí atsiniltłʼish ííłʼínígíí	Torpediniformes
Chʼil łitsxooí ntsxaaígíí	Citrus ×paradisi
Kʼíníjíłʼahí (dííshjį́ ááłjiní)	Groseillier à maquereau
Kʼaalógiiłgaígíí	Pieridae
Naʼastsʼǫǫsí binááʼ áłtsʼíísígíí	Soricidae
Dzaanééz	Mulet
Tsinlátah shash łichíʼígíí	Ailurus fulgens
Tsídii jáádnézí	Phoenicopterus
Tééh łééchąąʼí	Hyaenidae
Łóóʼtsoh dootłʼizhígíí	Baleine bleue
Sóól	Érable
Aghaaʼ	Laine
Deesdoigi	Tropique
Shádiʼááhdę́ę́ʼ tłʼízí	Lama (animal)
Mósíʼilí	Persan (chat)
Lókʼaatah mósí ałchiní	Chaus
Náátsʼózídę́ę́ʼ mósíłkizhii ałchinígíí	Chat-léopard
Náshdóítʼą́ʼí łikizhígíí	Serval
Tábąąh béégashii	Bubalus bubalis
Béégashiitsoh naʼałkǫ́ǫ́ʼígíí	Lamantin
Hastiin Leiw Éíwiksson	Leif Ericson
Akágí yitsʼǫǫsii	Hirudinea
Anáʼálwoʼ:TʼAN (FAQ)	Aide:FAQ
Táłkááʼ tsʼin	Crocodylidae
Chidítsoh	Camion
Dlǫ́ʼiitsoh áłtsʼózígíí	Genetta
Gáagii	Corvus
Tó wónaanídę́ę́ʼ náshdóí	Lynx boréal
Jááłánii (bitsiitsʼiin nteelígíí)	Chilopoda
Giní	Faucon
Dahiitį́hii	Trochilidae
Tązhii	Dinde
Chʼosh (Bíígháán Ádaadinígíí)	Invertébré
Gáagii naashchʼąąʼígíí	Coraciidae
Mąʼii	Coyote
Dah Naatʼaʼí Sǫʼ bił Sinil	The Star-Spangled Banner
Akʼah sisíʼí tsin	Eucalyptus
Mááya dinéʼiʼ	Mayas
Gahtsoh	Lièvre
Bisóodi bíchį́į́h nineezí	Oryctérope du Cap
Sonora Hahoodzo	Sonora
Nahakʼízii	Gryllidae
Chaaʼ	Castor (genre)
Chʼilzooł	Brocoli
Kááʼtsʼiní	Dasypodidae
Atsʼiis naałdzid	Cancer du poumon
Yágháhoníkáángóó ałánátʼahí	Navette spatiale américaine
Béésh náábałí atsiniltłʼish ííłʼínígíí	Éolienne
Méhigo tééh	Vallée de Mexico
Shą́ą́ʼnahalghałí (naaldeehii)	Hyracoidea
Nahatʼeʼiitsoh łichíiʼii	Kangourou roux
Azeeniłchin	Lamiaceae
Chʼał	Anoures
Tsxilghááh	Caudata
Shádiʼááhdę́ę́ʼ atsátsoh	Harpie féroce
Shádiʼááhdę́ę́ʼ chʼał kʼaasdáhígíí	Dendrobatidae
Chʼał niłtólí	Centrolenidae
Chʼał dichʼízhí	Bufonidae
Tónteel tsídiitsoh	Diomedeidae
Chʼał atʼąąʼ nahalinii	Megophryidae
Naashgalí	Mescaleros
Bisóodi ałchiní	Sanglier
Naʼastsʼǫǫsí dóó Łéʼétsoh Danilínígíí	Muroidea
Mariner 10	Mariner 10
Sǫʼ łóóʼ bigaanézí	Ophiuroidea
Dághaałóóʼ	Siluriformes
Łóóʼtʼą́hí	Pleuronectiformes
Toohjįʼ ndiigaii	Aigrette neigeuse
Kʼaalógii bitseeʼ hólóní	Papilionidae
Mágí binááʼtsohígíí	Tarsier
Tó wónaanídę́ę́ʼ dlǫ́ʼiiłkizhii	Vormela peregusna
Díłdánii	Odontophoridae
Táłtłʼááh łį́į́ʼ	Hippocampe (poisson)
Łóóʼ bíígháántsiighąąʼ ádaadinígíí	Myxinidae
Béésh Sinil	Winslow (Arizona)
Achʼįʼ Náhiłtį́į́	Safford (Arizona)
Tó wónaanídę́ę́ʼ dzeeh	Cerf élaphe
Tsézhin Deezʼáhí	Saint Johns (Arizona)
Béésh Bá Hooghan	Globe (Arizona)
Kinłání (Hoozdoh Hahoodzo)	Flagstaff (Arizona)
Michoacán Hahoodzo	Michoacán
Tʼiisyaakin	Holbrook (Arizona)
Naʼníʼá Hótsaa	Page (Arizona)
Táłtłʼááh chʼosh daadánígíí	Caridea
Mágíshzhin	Chimpanzé
Łóóʼntsxaaí łikizhígíí	Requin-baleine
Dlǫ́ʼii yił Aheedaałtʼéhígíí	Herpestidae
Béésh Bichʼahníí Bikéyahdę́ę́ʼ ayání	Bison d'Europe
Łóóʼtsoh bitsiiʼ dikʼání	Grand cachalot
Waaʼ (dííshjį́ ááłjiní)	Épinard
Néʼéshjaatsoh	Grand-duc d'Amérique
Shádiʼááhdę́ę́ʼ tłʼízíʼilí	Alpaga
Chʼosh ditłʼooí	Chenille (lépidoptère)
Łóóʼ bigaan neeznání	Calmar
Bijáád noodǫ́ǫzii	Okapi
Méhigo Hahoodzo	État de Mexico
Ayání	Bison d'Amérique du Nord
Mąʼiiłgaii	Renard polaire
Táłtłʼááh chʼosh chʼééh digháhii bideetsohígíí	Anaspidea
Gólízhii Danilínígíí	Mouffette
Táłtłʼááh adijiłii	Echinoidea
Nahachagii	Caelifera
Wóóneeshchʼįįdii (nahachaʼígíí)	Locuste
Tsídiitsoh ditsʼozígíí	Émeu d'Australie
Ałhaʼdeetʼaah	Contrat
Naayééʼ tsídii	Archaeopteryx
Tsísʼná (bitłʼizh ííłʼínígíí)	Apis (genre)
Chééwokii dinéʼiʼ	Cherokees
Tsin naaʼeeł hééł bee nágéhéʼ	Navire de charge
Ałtį́į́ jikʼáshí áłtsʼózígíí (chʼil)	Prêle des champs
Yéigo ałhoshii	Gliridae
Naʼashjéʼii bijéí dah łichíiʼii	Veuve noire
Mágí dághaaʼígíí	Tamarin empereur
Didzéłchííʼ	Ilex
Naałání	Comanches
Oozéí / Ayahkinii	Hopis
Toohjįʼ noołnahiitsoh	Héron goliath
Bidááʼ Haʼaztʼiʼ Tsékooh	Grand Canyon
Táłtłʼááh naʼashjéʼii	Argyroneta aquatica
Táłtłʼááh tsisteełtsoh	Tortue luth
Nahatʼeʼii	Dipodomys
Tsídii yáłtiʼí yázhí	Perruche ondulée
Tábąąh mąʼii	Raton laveur
Hołchʼíʼí	Ortie
Tsįdláád	Usnée
Dáághahii dinéʼiʼ	Français (peuple)
Shash łizhinígíí	Ours noir
Náshdóí bizaʼazis hólóní	Thylacine
Łeeyiʼ chʼosh	Lumbricina
Shash bitéélgaígíí	Ours noir d'Asie
Chʼoshtʼą́hí	Platyhelminthes
Hashtłʼish jeeshóóʼ	Gypaète barbu
Jádí bíchį́į́htsohígíí	Saïga
Táłtłʼááh chʼoshtsoh chʼééh digháhii	Holothurie
Tsísʼná bizǫ́ǫ́z ádinígíí	Meliponini
Chidí naatʼaʼí dilwoʼí	Avion de chasse
Bíchį́į́h naatsʼǫǫdí	Tapir
Tó wónaanídę́ę́ʼ mąʼii	Chacal doré
Chʼóshgai (tsin)	Épinette blanche
Łóóʼ Bigaan Dahólónígíí	Cephalopoda
Naʼashǫ́ʼii łóóʼ	Anguilliformes
Dahbaʼ (tsin)	Frêne
Łóóʼ hashkéhétsoh	Grand requin blanc
Neeshchʼííłchííʼ	Castanea
Chį́į́hnézí nahatʼeʼígíí	Macroscelidea
Táłtłʼááh ayání	Dugong
Dibé Diníí Bikéyahdę́ę́ʼ náshdóí	Lynx pardelle
Maadíséloo	Monticello (Utah)
Kʼaiʼ Bił Hahazteel	Kanab
Toohjįʼ ndiigaiitsoh	Grande Aigrette
Wóóneeshchʼįįdii	Cicadidae
Dééshzhiin	Cygne noir
Naakaii náásééł	Mantodea
Dlǫ́ǫ́ʼ ntsxaaígíí	Capybara
Mąʼii bijaaʼtsohí	Fennec
Dilchaʼ	Marmotte
Díwózhii	Sarcobatus
Náshdóí łibáhígíí	Lynx roux
Chʼilhaatʼaʼii	Faucon émerillon
Tééh hóyáaniitsoh	Béluga (baleine)
Jádí bideeʼ yisdizígíí	Impala
Náátsʼózídę́ę́ʼ mąʼiiłchííʼ	Dhole
Łóóʼtsoh bighą́ą́ʼ yílkʼidígíí	Baleine à bosse
Ghą́ą́ʼnaakiskʼidii	Chameau de Bactriane
Tábąąh mąʼiiniiʼí	Chien viverrin
Naʼazhǫǫsh (ndajiné dóó adazhdikaʼgi)	Casino (lieu)
Ndikʼąʼ	Gossypium hirsutum
Dlǫ́tʼą́ʼí	Suricate
Azeeʼ hókániitsoh (chʼil daadánígíí)	Artichaut
Kéchwa dinéʼiʼ	Quechuas
Mąʼii bizaʼazis hólóní	Diable de Tasmanie
Shash bítááʼłgaígíí	Ours à lunettes
Jádítsoh	Grand koudou
Naatʼáanii Moctezuma II	Moctezuma II
Biwooʼ Ádaałtsʼíísígíí	Pilosa
Ásáí dinéʼiʼ bikéyah	Monde arabe
Shash yázhí	Ours malais
Shash ndilnaʼii	Ours lippu
Teeł	Typha
Hwéeldi	Longue marche des Navajos
Chʼódeenínii	Épicéa bleu
Łéʼétsoh yiljaaʼí	Renoncule
Hakʼaz náshdóí	Lynx du Canada
Mąʼii yił Ałhidanoolinígíí Yázhí	Procyonidae
Béésh Bichʼahii beʼakétłʼóól dijoolí	Chou-rave
Nahooyéí (chʼil naʼatłʼoʼii)	Convolvulus
Tłʼoh waaʼí nahalinígíí	Trèfle blanc
Tséʼésgízii	Ribes aureum
Tábąąstííntsoh dághaaʼígíí	Phoque barbu
Atʼééké bijish yázhí	Chou de Bruxelles
Tsékooh	Gorge (géographie)
Noodah	Agave
Łeeʼdoolʼeezí	Orobanchaceae
Kinteel Bił Hahoodzo	Comté de San Juan (Nouveau-Mexique)
Beeʼeldííl Dahsinil Bił Hahoodzo	Comté de Bernalillo
Aniłtʼánii	Neuroptera
Kʼaalógii bijáád dį́įʼii	Nymphalidae
Nímasii yiyání	Doryphore
Awééʼchíʼí (chʼil)	Campanule
Taʼaghálii	Astragale (flore)
Naaʼołí yiltʼąąʼí	Lathyrus
Azeeʼ ndootʼeezhí łibáhígíí	Marrube blanc
Hastóí tsiiyéélí	Clématite
Chʼilátah atsʼos	Épilobe
Kʼish	Aulne blanc
Dééłjáád	Rumex crispus
Shį́náldzidí (chʼil bilátah hózhóón)	Antirrhinum
Kʼįįʼ	Rhus
Naaztání	Févier d'Amérique
Táłkááʼbéésh	Sagittaire (plante)
Tsinyaa tłʼoh	Pâturin
Tłʼééʼ yiigáhii	Œnothère
Tłʼoh deeskʼidí	Amarante réfléchie
Ndootʼeezhí	Monarda
Wóóseekʼidii	Sphingidae
Dzílí bíláshgaan	Erodium cicutarium
Díkʼǫ́ǫ́zhí (chʼil)	Atriplex
Tʼąąʼdoolghasí	Potentille ansérine
Teełikaní	Troscart maritime
Láʼashdlaʼ	Parthenocissus quinquefolia
Tséghániłchʼi	Portulaca oleracea
Zééʼiilwoʼii	Vulpin
Chéchʼil ntłʼizí yiltʼąąʼí	Mahonia aquifolium
Tólchiintsoh	Épiaire des marais
Tséyaa hataałí	Rutabaga
Tłʼohtsʼózí	Juncus
Tłʼoh dichʼíízh	Carex
Shashdą́ą́ʼ	Berbéris
Tłʼoh waaʼítsoh	Mélilot blanc
Díkʼǫ́ǫ́zhí yiltʼąąʼí	Chenopodium album
Bįįh yildeeʼí	Physalis
Kʼaalógii bitʼaʼ ndikʼąʼ nahalinígíí	Lycaenidae
Hosh niteelí	Opuntia
Teeł bitʼąąʼłánígíí	Scirpus
Chʼał nineezí	Ouaouaron
Tééh hóyáanii bíchį́į́htsahí	Narval
Mágí bíchį́į́htsohígíí	Babouin
Bįįh łikizhígíí (Béésh Bichʼahníí Bikéyahdę́ę́ʼígíí)	Daim
Tábąąh ayání	Buffle d'Afrique
Nátʼostsoh	Molène thapsus
Teeł náyizí	Juncus balticus
Tólchiin (chʼil)	Menthe des champs
Táłkááʼ dah yikał	Nasturtium
Binaʼadaałtzózí	Japonais (peuple)
Kʼįįshzhíní	Cerisier de Virginie
Chʼil awoshí	Soude brûlée
Chʼil naamaasii	Amarante blanche
Yéʼiibeʼetsʼos	Brome des toits
Kʼaiʼ łichíʼii	Cornus sericea
Tsáʼásziʼ nteelí	Yucca gloriosa
Ostseʼ yiltʼąąʼí	Descurainia sophia
Azeediilchʼílii	Lupinus angustifolius
Toohjįʼhotso (chʼil)	Héliotrope de Curaçao
Kʼįįʼ łitsooí	Berberis repens
Dzidzé ditʼódí	Amélanchier à feuilles d'aulne
Gad yił aheełtʼéhígíí	Tamarix
Łóóʼ bíchį́į́h nineezí	Espadon
Łį́į́ʼ Ndahalinígíí	Equidae
Binááʼ Ádaałtsʼózí bichʼil łigaií	Pe-tsaï
Azeedíchʼííʼ	Piment
Kolíya Tááʼ Bikéyahą́ą	Trois Royaumes de Corée
Łeehdoolʼeez łichííʼí	Betterave potagère
Hashkʼaantsoh yiltʼeesígíí	Banane plantain
Chʼah Diʼilii Bikéyahdę́ę́ʼ mósí ałchinígíí	Chat de Pallas
Tááʼyaʼniiltʼóshiiłbáhígíí	Cardinal pyrrhuloxia
Jááłánii (bikágí ntłʼizígíí)	Diplopoda
Iichʼąhii ntsxaaígíí	Attacus atlas
Łóóʼ ńdídzihígíí	Dipnoi
Chʼíshiibeezhii	Paridae
Giní jáádnézí	Messager sagittaire
Hakʼaz néʼéshjaaʼ	Harfang des neiges
Shádiʼááhdę́ę́ʼ jeeshóóʼ	Condor des Andes
Chidí naatʼaʼítsoh beeʼeldǫǫh bikǫʼ neiyéhé	Bombardier (avion)
Shash bighą́ąʼgi hadzíbáhí	Grizzli
Kǫʼ naʼałbąąsii	Locomotive à vapeur
Ndíyíliitsoh	Tournesol
Naaʼahóóhaiłkizhígíí	Pintade
Tłʼiish yighání	Ratel
Dadilhóni aheltłʼidígíí	Grenade à main
Naakaii Łizhiní Bikéyahdę́ę́ʼ łééchąąʼí ałchiní	Lycaon (mammifère)
Aniłtʼánii (tʼááłaʼajínígoʼígíí)	Ephemeroptera
Ayánítsoh bighą́ą́ʼaskʼidígíí	Gayal
Máaz yikááʼ nandahí Spirit	Spirit (rover)
Naʼníʼá Hótsaadi atsiniltłʼish bá hooghan	Centrale thermique de Navajo
Hakʼaz giníłgaii	Faucon gerfaut
Tsétah jeeshóóʼ łibáhí	Vautour fauve
Tééh łééchąąʼí łikizhígíí	Hyène tachetée
Tłʼízí ałchiní	Capra aegagrus
Yaaʼ dóó chʼosh bíchį́į́h dadichʼízhí	Acanthocephala
Beeʼeldǫǫh	Mousquet
Chʼosh bitsʼaʼígíí bigaan dahólónígíí	Brachiopoda
Tʼąąʼdoolghasí (daadánígíí)	Chicorée endive
Dlǫ́ʼii (bílaʼashdlaʼii bilį́į́ʼ)	Furet
Łóóʼtsoh łibáhígíí	Baleine grise
Chʼah Diʼilii Bikéyahdę́ę́ʼ atsátsoh	Aigle des steppes
Yiisnááh	Prisonnier de guerre
Dzeeh	Wapiti
Tsinlátahgi tsídii nahatʼeʼígíí	Coliidae
Nátʼoh (chʼil)	Nicotiana tabacum
Tsin naaʼeeł bee daʼahijighánígíí	Cuirassé
Tsísʼná yiyání	Meropidae
Dlǫ́ʼiitsoh naalzheehígíí	Fossa (animal)
Nahachagii biyázhí	Aphidoidea
Naalkʼįhiitsoh	Dermoptera
Łóóʼ naatʼaʼí	Exocoetidae
Hakʼaz ayání	Bœuf musqué
Tsétah gah	Ochotona
Mąʼiitsoh bikʼos bineʼdę́ę́ʼ łizhinígíí	Loup à crinière
Iichʼąhiitsʼósí	Trichoptera
Kéyah Dańlínídę́ę́ʼ atsátsoh	Aigle des singes
Tábąąstííntsoh bíchį́į́htsohígíí	Éléphant de mer
Łóóʼntsxaaí díníchʼahii	Requin pèlerin
Chʼosh yighání	Protèle
Mágí bitseeʼ noodǫ́zígíí	Lémur catta
Táyiʼ chʼoshnézí	Nemertea
Dlǫ́tsʼósí łibáhígíí	Mangouste à dix raies
Tó naagoʼ	Goutte (physique)
Dlǫ́ʼiitsoh Danilínígíí	Viverridae
Mágí bigaanézí	Hylobatidae
Bílaneezii	Aye-aye
Séí mąʼii	Vulpes corsac
Naalʼeełítsoh bitéél halchíʼí	Bernache à cou roux
Tłʼízí bideeʼ yisdizígíí	Markhor
Jádí	Antilocapra americana
Wónikǫsí	Phasmatodea
Łóóʼ biyaatsʼiin ádaadinígíí	Hyperoartia
Tééh łééchąąʼí noodǫ́zígíí	Hyène rayée
Tsídiiłchxoní	Hoazin huppé
Táłtłʼááh chʼoshtʼą́hí bikááʼtsʼinígíí	Polyplacophora
Mąʼii bighą́ąʼgi hadzíjiní	Chacal à chabraque
Naakaii Łizhiní Bikéyahdę́ę́ʼ mąʼiiłchííʼ	Loup d'Abyssinie
Tsétah dibé	Mouflon canadien
Dibé dóó Tłʼízí Ndahalinígíí	Caprinae
Mágí bíchį́į́h dootłʼizhígíí	Mandrillus sphinx
Tó wónaanídę́ę́ʼ dibé ałchiní	Mouflon
Tsiighájíłchí	Cuscuta
Bįįhyázhí biwooʼnézí	Porte-musc de Sibérie
Dzeeh łikizhígíí	Cerf Sika
Tábąąh mósí ałchiní	Chat viverrin
Chį́į́h yee achʼiishíhii	Pristidae
Shádiʼááhdę́ę́ʼ hodíłchʼil mąʼii	Chien des buissons
Hakʼaz mágí	Macaque japonais
Tsé Biiʼ Ndzisgaii	Monument Valley
Mágí bíchį́į́h niilyoolígíí	Nasalis larvatus
Shádiʼááhdę́ę́ʼ tsídiitsoh	Nandou d'Amérique
Dáádílí łibáhígí	Epinephelus marginatus
Ayání dóó Béégashii Danilínígíí	Bovini
Náátsʼózídę́ę́ʼ mósíłtsxooí ałchinígíí	Chat de Temminck
Łóóʼnteeltsoh	Môle (poisson)
Gaanłáníchilí dóó Gaanłání doo yitʼíinii	Hydre (zoologie)
Atłʼóóh	Tissage
Chʼoshkʼaaʼ	Chaetognatha
Tábąąh bįįh	Hydropotes inermis
Hodíłchʼil jeeshóóʼ	Sarcoramphe roi
Dlǫ́ǫ́ʼ bitseetłʼooígíí	Chinchilla
Achʼąąʼ adáʼatsʼiʼ	Vaccination
Néʼéshjaaʼ bíńdáhii	Chouette épervière
Bitseeʼ yee adiłhałii	Alligator d'Amérique
Jádítsoh noodǫ́zígíí	Bongo (animal)
Níyolgi naatʼaʼígíí (tónteel tsídii)	Hydrobatidae
Tádídíín yiyání	Chrysomelidae
Tsídiidaashiyishí	Ibis (oiseau)
Yílnoodii (łóóʼ)	Sphyraena
Shádiʼááhdę́ę́ʼ łéʼétsoh bitseeʼ ádinígíí	Dasyprocta
Chʼosh bitsʼaʼłáaʼii	Monoplacophora
Naʼashǫ́ʼii łóóʼ hashkéhé	Requin-lézard
Jeeshóóʼ	Condor de Californie
Táłkááʼ chʼó	Berle dressée
Chʼosh dilwoʼígíí	Cicindelinae
Tsin ditʼinii	Spermophile
Joogii	Geai bleu
Łeeyiʼ nahakʼízii	Gryllotalpidae
Náátsʼózídę́ę́ʼ naalʼeełí	Canard mandarin
Mąʼii bijaaʼabanígíí	Renard à oreilles de chauve-souris
Yéʼii bitsáʼásziʼ	Yucca elata
Tsídiitsoh bikʼos dootłʼizhí	Casuariidae
Atsiniltłʼish ííłʼíinii (naʼashǫ́ʼii łóóʼ)	Anguille électrique
Dįʼ	Tetraoninae
Łeeyiʼ tłʼiish áłtsʼíísígíí	Scolecophidia
Niicháadii (łóóʼ)	Tetraodontidae
Tééhoołtsódiichilí	Hexaprotodon liberiensis
Kʼiiznoodǫ́ǫzii (tsin yigházhígíí)	Cuniculus (genre)
Wóláchííʼ yildeełítsoh	Tamanoir
Dibéʼniiʼí	Moucherolle à ventre roux
Bináʼadaałtsózí bitsin naaʼeeł	Jonque
Níłtsą́goʼ (bideeneezígíí)	Cerambycidae
Tséʼédǫ́ʼii bitsiinézí	Mecoptera
Tłʼohtahgi díłdánii yił aheełtʼéhii	Turnicidae
Łóóʼyiniʼįįhí (tónteel tsídii)	Stercorariidae
Shádiʼááhdę́ę́ʼ tó hóyáanii	Boto
Naʼashǫ́ʼiitsoh	Iguana
Łóóʼ adishishí	Dasyatidae
Tsin yąąh dzootʼihí	Sitta
Atʼaʼ yiltʼąąʼí dah sidáhígíí (chʼosh ntsxaaígíí)	Crabe de cocotier
Yółeehii	Lophiiformes
Tiníléí	Monstre de Gila
Dijádídlǫ́ʼí	Alouette hausse-col
Tłʼoh	Gazon
Dinas	Arctostaphylos uva-ursi
Mąʼii bikʼiizgi hadzíjiní	Chacal à flancs rayés
Yadiizį́įgo ayání	Gazelle de Waller
Télii bijáád noodǫ́zí	Âne sauvage d'Afrique
Bitsʼáá bidaʼhodiʼniil	Politique de la terre brûlée
Mágíłchííʼ	Tamarin lion doré
Dááʼadeeʼii	Spatule (oiseau)
Łóóʼ hashkéhé bitsiiʼ dikʼání	Sphyrnidae
Taahilnoodii	Sulidae
Kʼíneedlíshii adiłhashígíí	Lucanidae
Łééh yidi tóʼígíí	Aquifère
Naʼashǫ́ʼiitsoh naʼałkǫ́ʼígíí	Iguane marin des Galapagos
Tsídiisháshii	Bombycillidae
Naakétłʼáhí	Pimas
Yaaʼ bitsʼaʼígíí	Coccoidea
Daateel	Savacou huppé
Tééh łééchąąʼí ditsʼozígíí	Hyène brune
Tsétaʼ łį́į́ʼ	Mustang (cheval)
Kénézí	Jacanidae
Neeshchʼííʼ	Pignon de pin
Naalʼeełítsoh yił aheełtʼéhii łizhin dóó łigaiígíí	Canaroie semipalmée
Mąʼii chʼil	Solidago
Yaadaaʼnézí (tónteel tsídii)	Bec-en-ciseaux
Tsídii disxǫsígíí	Galbulidae
Náátsʼózídę́ę́ʼ mósíłchíiʼii ałchinígíí	Chat bai
Shádiʼááhdę́ę́ʼ tsétah mósí ałchinígíí	Chat des Andes
Tsinlátahgi dlǫ́ʼiitsoh	Binturong
Jeeshóóʼ łizhinígíí	Urubu noir
Naałʼashí	Theraphosidae
Dééłdą́ą́ʼ	Pteridium aquilinum
Hashkʼaan yildeełígíí (tsídii)	Musophagiformes
Łį́į́chilí	Shetland (cheval)
Daakʼį́į́ʼ	Courlis
Mąʼiiłtsooí łibáhígíí	Renard gris
Naʼashǫ́ʼiitsoh dootłʼizhígíí	Iguana iguana
Chidí bikéíjį́ʼ adeizʼááhígíí	Pick-up
Bįįh bitseełgaiígíí	Cerf de Virginie
Wónitłʼizí	Cloporte
Díʼdikii (jádí)	Madoqua
Hakʼaz mąʼiitsoh	Loup arctique
Dark Ages	Âge sombre
Ndikʼąʼ biyaʼ	Charançon du cotonnier
Tłʼoh naadą́ą́ʼ biyaʼ	Charançon du blé
Łeeyiʼ jááłániichilí	Pauropoda
Aniłtʼánii (bikʼosnézí)	Raphidioptera
Dlóóʼ binaalniih	Peste bubonique
Naaʼołí biyaʼ	Bruchinae
Tséʼédǫ́ʼii dishooí	Syrphidae
Tsáʼásziʼ dóó Noodah	Agavaceae
Tééh tsisteeł	Tortue marine
Bichʼah Dootłʼizhii	Force de maintien de la paix des Nations unies
Dlǫ́ʼii łizhin dóó łitsooígíí	Martes flavigula
Chʼosh ałchozhii (chéłchaaʼ)	Dermestidae
Łeʼesoołii (bitseeʼ naakiígíí)	Diplura (Hexapodes)
Dlǫ́ʼátsoh	Marmota monax
Chʼééh digháhii dóó Tsisteeł	Tortue
Tááʼyaʼniiltʼóshii	Cardinalidae
Łóóʼ bigaanłánígo bitsʼaʼígíí	Nautilidae
Łeʼesoołii (bitseeʼ tááʼígíí)	Thysanura
Tłʼézhii	Tabanidae
Tániilʼáítsʼóóz	Zygoptera
Naashtʼézhí	Zuñi
Aniłtʼániitsʼóóz	Myrmeleontidae
Tó wónaanídę́ę́ʼ hazéí bíchį́į́hnézí	Scandentia
Hakʼaz gah	Lièvre arctique
Bįįh łikizhígíí (Naakaii Dootłʼizhii Bikéyahdę́ę́ʼígíí)	Cerf axis
Nahashchʼidí (naaldeehii)	Blaireau d'Amérique
Bisóodi bideeʼ názhahígíí	Babiroussa
Tsídii bichʼahtsooígíí	Calao bicorne
Shádiʼááhdę́ę́ʼ bisóodi diʼilígíí	Tayassuidae
Náʼagéédí bizaʼazis hólóní	Taupes marsupiales
Bilagáana	Blanc (humain)
Tłʼézhiiłbáhí	Tachinidae
Shash nátʼoh	Tribule terrestre
Jádítsoh diłhiłígíí	Nyala
Jádítsoh bideeʼ shiyishígíí	Hippotrague noir
Dlǫ́ʼiitsoh łikizhígíí	Civettictis civetta
Tsinaʼayąʼii yildeełí	Myrmecobius fasciatus
Tsétah tłʼízí	Chèvre des montagnes Rocheuses
Jááłániichilí bighádzígaiígíí	Symphyla
Gahchilí	Brachylagus idahoensis
Tsiishgaii	Sittelle pygmée
Cháʼoł bidahtsʼaaʼ	Arceuthobium
Tsį́į́łkaałiichilí	Picumninae
Dééłgai bitsiiʼ halzhinígíí	Cygne à cou noir
Chʼosh nahachagii	Cicadellidae
Hóółtseiigi naʼastsʼǫǫsí	Gerbille
Gaanłání	Ceriantharia
Dibédą́ą́ʼ	Shépherdie
Tádídíín yiyání łichíʼígíí	Lilioceris lilii
Laanaa Yáʼátʼéehgo Késhmish	We Wish You a Merry Christmas
Naʼazǫ́ǫzii	Mutillidae
Jáád neishoodí (naʼashjéʼii haalzheehígíí)	Pompilidae
Naalʼeełí bidaatsʼózí	Mergus
Chį́į́shłigaií (bílaʼashdlaʼii bilį́į́ʼ)	Oie domestique
Naalʼeełí łizhinígíí	Melanitta
Nahatʼeʼiitsoh Bikéyahdę́ę́ʼ naalʼeełítsoh łibáhígíí	Céréopse cendré
Dahsánítsoh	Hystrix cristata
Naʼastsʼǫǫsí bitseeʼ dichʼízhí	Acomys
Tsétah nahatʼeʼiitsoh	Pétrogale
Táłkááʼ dilwoʼí	Gerridae
Akáshtʼóózh biyaʼ	Psocoptera
Łeʼesoołii (bideeʼ ádinígíí)	Protura
Ąąʼąʼii	Pica (genre)
Jádí bideeʼ dį́įʼii	Antilope tétracère
Táłtłʼááh chʼosh ntsxaaígíí	Macrocheira kaempferi
Mósí ałchiní bitsiiʼtʼąhígíí	Chat à tête plate
Naakaii Łizhiní Bikéyahdę́ę́ʼ naalʼeełítsoh dibéłchíʼígíí	Ouette d'Égypte
Hosh aditsahiitsoh	Saguaro
Tʼáá łichíʼígo náʼagéédí	Rat-taupe nu
Tsisteeł łizhinígíí	Tortue charbonnière à pattes rouges
Tééh jeeshóóʼ	Vautour africain
Iichʼąhii noodǫ́zí	Sphinx orangé
Atʼąąʼ nahalinii	Phylliidae
Ghą́ą́ʼnoodǫ́ǫzii (tsin yigházhígíí)	Dinomys branickii
Tsáʼásziʼ bideeʼí	Yucca baccata
Łéʼétsoh beeniʼíhoniitaahígíí	Cavia
Naʼashǫ́ʼii dichʼízhii	Phrynosoma
Chéłchaaʼ bikʼosnézí	Scarabée girafe
Ásaaʼ neiyéhii	Meloidae
Naʼashǫ́ʼiitsoh łitsooígíí	Conolophus subcristatus
Shádiʼááhdę́ę́ʼ tiníléí	Lézard perlé
Sahdii Bisí (Tsé Nástánii)	Parc national de Petrified Forest
Tsé Bighánílíní	Antelope Canyon
Naakaii Dootłʼizhii bimósí ałchinígíí	Chat rubigineux
Naʼashǫ́ʼiiłchííʼ dootłʼizhígíí	Agama mwanzae
Kʼaabizhii	Mammillaria
Dahiitį́hídą́ą́ʼtsoh	Castilleja
Wálázhini	Messor (genre)
Dlǫ́ʼbéʼézhóóʼ	Aristide (plante)
Chʼil abeʼéntsxaaí	Asclepias tuberosa
Ndilkal (chʼil)	Cucurbita foetidissima
Chʼįdą́ą́ʼ	Céanothe
Jáád neishoodí (łeyiʼdi bighanígíí)	Sphex
Dáʼághálii	Crotalaria
Chʼał bikʼos ádinígíí	Nasikabatrachus sahyadrensis
Níłtsą́goʼ	Pleocomidae
Jéí náyoogisii	Echinocereus
Tłʼohtah náshdóí	Leopardus pajeros
Tsídii naʼałkǫ́ʼígíí	Fratercula
Tsisteeł diyogí	Matamata
Łóóʼ adishishí ntsxaaígíí	Raie manta
Tónteel bibąąh hóyáanii	Neophocaena phocaenoides
Naakaii Łizhiní Bikéyahdę́ę́ʼ tsétah dibé	Mouflon à manchettes
Náhookǫsdę́ę́ʼ dlǫ́ʼii	Martes americana
Naalʼeełí naashchʼąąʼígíí	Canard branchu
Tsinlátah nahatʼeʼiitsoh	Dendrolagus
Tsin naaʼeeł łóó beeʼháʼhaalʼééłiʼ	Chalutier
Chʼosh biyaʼ	Strepsiptera
Táłtłʼááh chʼosh	Dytique
Gáagii dinéʼiʼ	Crows
Shádiʼááhdę́ę́ʼ tábąąstííntsoh	Otarie à crinière
Táłtłʼááh álééh	Grand Héron
Tsísʼnáłtsooítsoh	Vespa (insecte)
Táłtłʼááh naakaii náásééł yił aheełtʼéhii	Stomatopoda
Náátsʼózídę́ę́ʼ tsiiłtsooí	Faisan doré
Bisóodi Danilínígíí	Suines
Gólízhii noodǫ́zígíí	Mouffette rayée
Tsinlátah naʼashǫ́ʼiitsoh	Iguana delicatissima
Tó bichʼosh (séigoʼ nahalinígíí)	Nèpe
Naʼastsʼǫǫsí bijaaʼntsxaaígíí	Macrotis lagotis
Tsʼání	Geai des pinèdes
Chʼééh digháhii bitsʼaʼ yilzhólí	Trionychidae
Chį́į́shghą́ʼiiłgaii	Sittelle à poitrine blanche
Hastiin Diego de Landa	Diego de Landa
Hastiin Biʼééʼ Łichíiʼii	Kit Carson
Tábąąstííntsoh (Akééháshį́į́dę́ę́ʼígíí)	Otarie de Californie
Mósí bizaʼazis hólóní	Dasyurus
Tségad	Selaginella
Naaʼołí	Haricot (homonymie)
Tsįyaalzhahí	Épervier brun
Hashtłʼishdi chʼééh digháhii	Kinosternidae
Yaaʼ nahachagiígíí	Siphonaptera
Kéʼ łizhiní	Confédération des Pieds-Noirs
Tábąąsdísí áłtsʼíísí	Chevalier grivelé
Náátsʼózídę́ę́ʼ toohjįʼ ndiigaii	Aigrette de Chine
Łóóʼtsoh (Ałtsʼáʼáztiin)	Baleine (homonymie)
Dlǫ́ʼii łizhiní	Putois à pieds noirs
Wóláchííʼ yildeełí łizhin dóó łigaígíí	Tamandua
Lókʼaatah bisóodi	Potamochoerus larvatus
Hodíłchʼil tłʼízí	Capricornis sumatraensis
Hakʼaz Dineʼé Bikéyahdę́ę́ʼ tábąąstííntsoh	Lion de mer de Steller
Dziłtah dlǫ́ʼii	Belette de montagne
Naayééʼ tsídiitsoh	Dinornithidae
Atseełtsoii	Buse à queue rousse
Tóniłhę́ęshii (dééł)	Grue blanche
Naaltsoos Mormon Wolyéhígíí	Livre de Mormon
Téél halchíʼí	Merle d'Amérique
Dlǫ́ʼátah néʼéshjaaʼ	Chevêche des terriers
Naʼashǫ́ʼii bijáád ádinígíí	Amphisbaenia
Naʼatłʼoʼii (chʼosh)	Embioptera
Dííłdzid yiyání	Staphylinidae
Tsintah łéʼétsoh	Neotoma
Kʼiishzhinii (tsin)	Charme de Caroline
Tʼiisbáí	Peuplier faux-tremble
Yáhashjool yázhí	Petit Blongios
Tłʼéeʼgo mágí	Douroucouli
Náʼagéédíchilí	Neurotrichus gibbsii
Tsʼíʼii jáádnézí	Tipulidae
Chʼil ditsʼozíłchííʼ	Ramboutan
Mágíłtsooí bináázhiní	Saïmiri commun
Taʼneeskʼání	Cantaloup
Tsídiiłtsooí bitʼaʼ łizhinígíí	Chardonneret jaune
Tsʼíʼii noodǫ́zí	Aedes albopictus
Bitseeʼ yee adiłhałii yázhí	Caimaninae
Anaasází	Anasazis
Chʼééh digháhiitsoh	Chelonoidis nigra
Tsineeshbízhii	Grimpereau brun
Yeenaʼałkǫ́ʼíłániichilí	Remipedia
Naʼnízhoozhí Bił Hahoodzo	Comté de McKinley
Mąʼii Deeshgiizh Bił Hahoodzo	Comté de Sandoval
Naatoohí Bił Hahoodzo	Comté de Cibola
Tábąąstííntsoh łikizhígíí	Phoca largha
Ooljééʼ yiikááʼ nandahí	Alunissage
Toohjįʼ noołnahii yázhí	Héron vert
Báshdo	Barstow (Californie)
Łóóʼ hashkéhé bíchį́į́hnézí	Requin-lutin
Tłʼiishtsiiʼí (łóóʼ)	Channidae
Chéłchaaʼ bideeneezígíí	Dynaste Hercule
Déłí	Grue du Canada
Ąąʼąʼiiłbáhí	Pie bleue
Tsétah chaaʼ	Aplodontia rufa
Sighóla	Socorro (Nouveau-Mexique)
Chéłchaaʼ disxǫsígíí	Buprestidae
Naalʼeełí dootłʼizhí	Sarcelle à ailes bleues
Béíyózhin	Païutes
Tsin naabąąs	Chariot bâché
Dlǫ́tsʼósí łichííʼígíí	Galidia elegans
2010 yihahígíí bílaʼashdlaʼii náóltahígíí	Recensement des États-Unis de 2010
Jádídlǫ́ʼii	Troglodyte familier
Yaayááhalzhiin	Bruant à gorge noire
Tséʼédǫ́ʼii	Muscidae
Chʼagiitsoh	Carouge à tête jaune
Dahsání dah Yikahjí Tsin Deigházhígíí	Hystricomorpha
Gad niʼeełí	Genévrier des Rocheuses
Níyolgi naʼałkǫ́ʼígíí (tónteel tsídii)	Pelecanoididae
Tsinaʼayąʼii biyázhí	Zoraptera
Sóól dichʼíizhii	Érable nain
Tseekʼi nástánii	Ammospermophilus
Tłʼízíʼilí	Angora (race caprine)
Naatooh Sikʼaiʼí	Grants (Nouveau-Mexique)
Tsooʼtsʼiní (łóóʼ)	Osteoglossidae
Tsinaʼayąʼii	Termite
Náʼagéédí bíchį́į́h sǫʼ nahalinígíí	Condylura cristata
Naaléełchííʼ	Conure à gros bec
Naaʼahóóhai disxǫsígíí	Lophophorus
Tsįyaatsiiłchííʼ	Moucherolle vermillon
Náhookǫsdę́ę́ʼ tsétah dibé	Mouflon de Dall
Níłtsą́goʼ łichííʼígíí (chʼil abeʼé bichʼosh)	Tetraopes tetrophthalmus
Naʼnízhoozhí	Gallup (Nouveau-Mexique)
Neeshchʼíínímazí	Noisette
Łóóʼ binááʼtsohí	Priacanthidae
Tsisteeł bikʼosneezígíí	Chelidae
Kilim	Kilim
Táłtłʼááh wónitłʼizí	Aselle
Naatsisʼáán bińdíshchííʼ	Pin flexible
Chąąneiłhizii	Histeridae
Tʼáyaałtso	Pic chrysoïde
Nákʼeʼnáʼijiní	Sittelle à poitrine rousse
Ałtaʼneetsʼéhii	Xanthium
Wáláchíʼétah nahachagiichilí	Myrmecophilidae
Yáhashjool yił aheełtʼéhii	Caurale soleil
Tsintah bisóoditsoh	Hylochoerus meinertzhageni
Zééjíjinii	Kamichi à collier
Naʼashǫ́ʼii hááʼáchʼiidí	Gambelia
Kááʼtsʼiní ditłʼooígíí	Chaetophractus
Naalkʼįhíchilí (bizaʼazis hólónígíí)	Acrobate pygmée
Dlǫ́ʼii yił aheełtʼéhii łibáhígíí	Herpestes edwardsii
Adijiłii yił aheełtʼéhí	Echinops telfairi
Łóóʼ hashkéhé bitseeneezígíí	Requin-renard commun
Chį́į́shłigaií dóó Naalʼeełítsoh	Anserinae
Jádí biniiʼtsʼózí	Alcelaphus buselaphus
Tábąąh jádí	Kobus ellipsiprymnus
Jádí binááʼ dį́įʼii	Hirola
Tó wónaanídę́ę́ʼ dlǫ́ʼáyázhí	Souslik d'Europe
Ásáí Dineʼé Bikéyahdę́ę́ʼ mąʼiitsoh	Canis lupus arabs
Dlǫ́iitsoh bíchį́į́hdzísgaiígíí	Paguma larvata
Aniłtʼánii yázhí	Psyllidae
Chʼał mágí nahalinii	Phyllomedusa sauvagii
Sǫʼ tsisteeł	Astrochelys radiata
Nahatʼeʼiitsoh Bikéyahdę́ę́ʼ tązhii	Talégalle de Latham
Mąʼii dootłʼizhí	Bassariscus astutus
Táłkááʼ dilwoʼítsʼóóz	Hydrometridae
Chʼoshtsoh bíláshgaantsohí łikizhígíí	Enoplometopus
Łeʼesoołii (nahachaʼígíí)	Archaeognatha
Tóidoozohii bidaaʼ łigaiígíí	Fulica
Chéłchaaʼtsoh	Dynastinae
Wódisxǫsí	Scutelleridae
Kʼaalógiitsoh disxǫsígíí	Morpho
Tsisteeł hashkéhé	Chelydridae
Tsilhazésii	Tyran à gorge cendrée
Naʼastsʼǫǫsí bizaʼazis hólóní	Antechinus
Wáláchííʼ	Myrmica rubra
Tsídiidą́ą́ʼ	Phlox (flore)
Wóniłchxoní	Pentatomidae
Tsiikʼánii (tsídii)	Ombrette africaine
Nahatʼeʼii niłchxoní	Hypsiprymnodon moschatus
Náátsʼózídę́ę́ʼ tsiidootłʼizhii	Argus géant
Ábishjaaʼ (daadánígíí)	Liste de champignons comestibles
Tábąąh bisóodiłchíiʼii	Potamochoerus porcus
Kéyah Dańlínídę́ę́ʼ naalʼeełí	Canard des Philippines
Tiníléítsoh naʼałkǫ́ʼígíí	Varan malais
Kézhoozhʼilí (tsin yigházhígíí)	Ctenodactylidae
Jádí bideeneezígíí	Oryx
Beehai	Jicarillas
Dáádílí łikizhígíí	Cromileptes altivelis
Tsísʼná náʼagéédígíí	Anthophorini
Mágíłbáhí	Cercopithecus mitis
Jaaʼditłʼoʼí naalkʼįhígíí (bizaʼazis hólónígíí)	Petauroides volans
Nahatʼeʼiitsoh yázhí	Thylogale
Tóshchíín / Naadą́ą́ʼ dootłʼizhí	Gaudes
Kʼiiłtsoii	Ericameria nauseosa
Séí tiníléítsoh	Varanus gouldii
Dlǫ́ʼii yił aheełtʼéhítsʼózí	Mangouste rouge
Łóóʼ bigháhootʼíní	Ambassidae
Tónhidigaii	Silverton (Colorado)
Chʼosh áłtʼą́ą́ʼígíí	Lygaeidae
Dééłtsoh	Outarde kori
Shádiʼááhdę́ę́ʼ dahsání	Coendou prehensilis
Nahatʼeʼiitsoh Danilínígíí	Macropodiformes
Zahalánii	Moqueur
Dlǫ́ʼii bitseenézí	Mustela frenata
Kéyahígíí nidineesdzaʼ	Dust Bowl
Nahachagii dootłʼizhí	Tettigoniidae
Tsé Bíyah Aniiʼáhí	Chaco Canyon
Nahatʼeʼiitsoh Bikéyahdę́ę́ʼ biyázhí neiyéhé	Trichosurus vulpecula
Naaʼahóóhaiłbáhí	Perdix (genre)
Tsísʼnádą́ą́ʼ	Gaillardia
Jeeshóóʼ ałchozhígíí	Palmiste africain
Łóóʼ adiłdoní	Toxotes
Dlǫ́ʼii yił aheełtʼéhii łitsxooígíí	Mangouste jaune
Naakaii Łizhiní Bikéyahdę́ę́ʼ nahatʼeʼii	Pedetes capensis
Táłtłʼááh chʼosh chʼééh digháhii bitsʼaʼ ádinígíí	Nudibranchia
Tiníléítsoh noodǫ́zígíí	Varan du Nil
Naʼashǫ́ʼii bideewozhii	Uromastyx
Chʼał ntsxaaígíí	Conraua goliath
Tééh naaʼahóóhaitʼą́ʼí	Francolinus
Naalʼeełí (bílaʼashdlaʼii bilį́į́ʼ)	Canard domestique
Yáhashjool	Butor d'Amérique
Dlǫ́ʼii yił aheełtʼéhii yázhí	Helogale parvula
Nahatʼeʼiitsoh Bikéyahdę́ę́ʼ tábąąstííntsoh	Lion de mer australien
Mąʼiiłtsooí yázhí	Renard nain
Gałbáhí	Sylvilagus
Tsékááʼgóó naagháhii (chʼosh)	Mantophasmatodea
Tłʼohtahilzhahí	Cariamidae
Táłtłʼááh tsxilghááhtsoh	Cryptobranchidae
Dibé dághaaʼígíí	Capricornis crispus
Chʼééh digháhii bitsiiʼntsxaaígíí	Platysternon megacephalum
Tsékʼi naʼałkǫ́ʼii	Desman des Pyrénées
Naʼastsʼǫǫsítsoh (chʼosh yildeełígíí)	Almiqui paradoxal
Tsídiiłtsooí	Paruline jaune
Chʼagii	Carouge à épaulettes
Łéʼétsoh diwozhí	Grand gymnure
Łéʼétsoh bizaʼazis hólóní	Dasyuroides byrnei
Dlǫ́ʼiitsoh noodǫ́zígíí	Civette palmiste à bandes
Tábąąstííntsoh łizhin dóó łigaiígíí	Histriophoca fasciata
Jeeshóóʼ bitsiiłgaiígíí	Vautour à tête blanche
Tábąądijádí	Pluvier kildir
Shádiʼááhdę́ę́ʼ niłchiis	Galictis
Naʼazísí	Geomyidae
Łeeyiʼ chʼał dichʼízhí	Rhinophrynus dorsalis
Naatsisʼáán	Navajo (montagne)
Táłtłʼááh naatʼáʼii	Dactylopteridae
Naakaii Dootłʼizhí Dabikéyah	Asie du Sud
Ńdaʼatʼaałii bideeʼ dahólónígíí	Pecora
Sháńdíín bitsʼą́ą́dę́ę́ʼ atsiniltłʼish álʼį́	Panneau solaire
Tsé noolchʼóshii	Troglodyte des canyons
Naaldlooshii	Quadrupède
Naaʼahóóhai bikeetsohígíí	Megapodius
Naʼashǫ́ʼii kááʼtsʼinígíí	Ouroborus cataphractus
Diltʼóshii	Baeolophus
Kinteel (Yootó Hahoodzo)	Aztec (Nouveau-Mexique)
Néʼétsah azeeʼ	Conyza canadensis
Naʼastsʼǫǫsí bitsʼohígíí	Hemicentetes
Atsá diłhiłígíí	Aigle noir (oiseau)
Ąąʼąʼii dootłʼizhígíí	Pirolle verte
Hastiin Dághaaʼ (Barboncito)	Barboncito
Bisóodi dághaaʼígíí	Sus barbatus
Iichʼąhii biyázhí	Aleyrodidae
Dólii	Merlebleu azuré
Kin Noodǫ́ǫ́z	Bernalillo
Hashtłʼishdi tádíʼnéehii	Oxudercinae
Tsiikʼánii (łóóʼ ooshgę́ęzhii)	Rhinobatidae
Biniiʼdootłʼizh	Glaucidium (oiseau)
Mágí biniiłgaígíí	Pithecia pithecia
Wónaʼałtéhii	Asilidae
Tłʼoh azihii	Ephedrales
Kʼaalógii bitʼaʼ disxǫsgo łikizhígíí	Riodinidae
Tiníléítsoh bikʼosnézí	Varan du désert
Shádiʼááhdę́ę́ʼ gahniiʼí ntsxaaígíí	Dolichotis
Łéʼétsoh bitseetłʼooígíí	Petromus typicus
Tsídii bizééʼ naashchʼąąʼí	Tragopan
Tábąąsdísíłbáí	Limnodromus
Dilzhę́ʼii	Geai de Steller
Mágí naashchʼąąʼígíí	Douc
Chʼosh naʼałkǫ́ʼí	Hydrophilidae
Tééh jádítsoh	Taurotragus
Łeeyiʼ bitiiní	Arvicolinae
Atsáłbáí	Faucon des prairies
Dáádílítsoh	Epinephelus lanceolatus
Tsétah bįįhchilí	Pudu
Tsʼánídílzhiʼí	Geai buissonnier
Iichʼąh	Convulsion
Kiisʼáanii	Pueblos
Jeeshóóʼ bitsiiłtsooí	Urubu à tête jaune
Dlǫ́ʼii noodǫ́zígíí	Poecilogale albinucha
Tiníléítsoh dootłʼizhígíí	Varanus prasinus
Yáázhłání (naaldlooshii)	Tenrec ecaudatus
Łéʼétsoh yił aheełtʼéhii	Octodontidae
Tábąąh łéʼétsoh	Hydromys chrysogaster
Ghą́ą́ʼdiʼilii (tsin yigházhígíí)	Lophiomys imhausi
Lókʼaaʼ yigházhígíí	Thryonomys
Tsídii bitʼaʼ dah adadootłʼizhígíí	Polyplectron
Dichin	Sous-alimentation
Dilchʼóshii	Junco
Chį́į́hʼadeeʼii (łóóʼ)	Polyodontidae
Hazéíntsxaaígíí	Ratufa
Kéyah Dańlínídę́ę́ʼ bisóodi bizęęs hastání	Sanglier des Visayas
Chąąneiłmaasii	Bousier
Dzílí	Épervier de Cooper
Chʼałniiʼí (łóóʼ)	Batrachoididae
Dah Naatʼaʼí Bééhoʼdílzin	Serment d'allégeance au drapeau des États-Unis
Tó bichʼosh (tsiiyaago naʼałkǫ́ʼígíí)	Notonectidae
Tónteel táshchozhii	Sterninae
Naʼastsʼǫǫsí noodǫ́zígíí	Lemniscomys
Tówoł	Taos
Kʼish biyaʼ dootłʼizhígíí	Galéruque de l'aulne
Dóliiłchííʼ	Merlebleu de l'Ouest
Łóóʼ binááʼ ádiní	Amblyopsidae
Tséłgaii Deezʼáhí	Bluff (Utah)
Aniłtʼánii (nahakʼízígíí)	Oecanthinae
Mágí bichį́į́łgaígíí	Cercopithecus ascanius
Tábąąh chʼosh	Saldidae
Naakaii Bikéyahdę́ę́ʼ bįįh yázhí	Mazama
Naʼashǫ́ʼii dootłʼizhí (naaldeehii)	Crotaphytus collaris
Naʼashǫ́ʼiiłbáhí	Dipsosaurus dorsalis
Dlǫ́tsʼósí noodǫ́zígíí	Galidictis grandidieri
Łéʼétsoh gahjaaʼígíí	Sauteur géant de Madagascar
Chʼoshtsoh bíláshgaanʼilí	Kiwa hirsuta
Anáʼálwoʼ:Bee hadítʼéhígíí	Aide:Sommaire
Táłtłʼááh chʼoshtsoh bideeneezí	Palinuridae
Táshchozhiizhiin	Moucherolle noir
Moháábii dinéʼiʼ	Mojaves
Néʼéshjaaʼkálii	Chevêchette des saguaros
Tsídii bitʼaʼ hózhóón	Paradisaea
Tiníléítsoh łikizhígíí	Varan Perenti
Tiníléítsoh bíchį́į́h dikʼání	Varanus albigularis
Tsé noolchʼóshiiłbáhí	Troglodyte des rochers
Chʼiyíítʼogii	Tyrannus
Dloziłgaii	Tamiasciurus
Tsísʼná dootłʼizhí	Chrysididae
Halchíítah	Painted Desert
Tsʼahchʼil	Sphaeralcea
Wóósitsʼílí	Cimex lectularius
Tsʼahgi naalnoodí	Sceloporus graciosus
Biizhii	Engoulevent d'Amérique
Tsidiłdǫǫhii	Megascops
Tsʼááhbįįh	Physaria
Łéʼétsoh binááʼ ádiní	Spalax
Tábąąh ndoochííʼ	Pirole verdâtre
Kǫʼ naʼałbąąsii hééł bee nágéhéʼ	Train de fret
Tádídíín dootłʼizh áłtsʼíísí	Campanula uniflora
Dlǫ́ʼiitsoh bizééʼ noodǫ́zí	Viverra tangalunga
Jaaʼabaní	Microchiroptera
Chʼosh chʼééh digháhii bideeʼ dį́įʼii	Stylommatophora
Wóláchííʼ yildeełí	Fourmilier
Niłchʼiʼ bee naalkaahiʼ	Geostationary Operational Environmental Satellite
Azeediłhiłí	Astragalus canadensis
Tséʼédǫ́ʼii łibáhígíí	Sarcophagidae
Hastiin Chʼil Haajiní (Manuelito)	Manuelito
Dlozishzhiin	Écureuil d'Abert
Tó Sido Háálį́	Pagosa Springs
Aniłtʼánii (naakaii náásééł nahalinígíí)	Mantispidae
Tsisteeł naʼazísí	Gopherus
Yoołgai (Hoozdoh Hahoodzo)	Superior (Arizona)
Kin Łání (Dibé Nitsaa Hahoodzo)	Durango (Colorado)
Tségháhoodzání	Window Rock
Tsé Yaatóhí	Cortez (Colorado)
Tótaʼ	Farmington (Nouveau-Mexique)
Táłtłʼááh chʼoshtsoh bideeteelí	Scyllaridae
Tséhootsooí	Fort Defiance (Arizona)
Lókʼaaʼdeeshjin	Keams Canyon
Tséyiʼ (Chʼínílį́įgiʼígíí)	Monument national du Canyon de Chelly
Chʼoshtsoh bíláshgaantsohí (tónteelgiʼígíí)	Nephropidae
Tábąąstííntsoh bighaaʼ díłchʼilígíí	Arctocephalinae
Kʼaiʼbisii	Grive fauve
Dlǫ́ʼiiłtsooí	Martes melampus
Táshchozhii dootłʼizhí	Hirondelle noire
Tsísʼnáłtsooí	Vespula
Azeeʼ hókánii łibáhígíí	Sonchus asper
Jélii łóóʼ daʼhólzhaʼígíí	Salpidae
Gólízhii binághah dah łigaiígíí	Mephitis macroura
Dloziłbáhí	Sciurus griseus
Nahatʼeʼii jáádnézí	Jaculus
Tsiiʼnteelí (łóóʼ)	Platycephalidae
Chíshí	Chiricahuas
Bikétłʼááh Hoolzhólígíí	Tylopoda
Chíshii Kʼíneeshbizhii	Paruline de Lucy
Táłtłʼááh séigoʼ bitsʼaʼígíí	Limulus polyphemus
Nááʼnoodǫ́ǫzii	Thlaspi
Tóidoozohii dootłʼizhígíí	Talève
Chʼagiiłbáhí	Molothrus
Jáád neishoodítsʼóóz	Ichneumonidae
Bitsiichįįshgahí	Cassenoix d'Amérique
Naʼashǫ́ʼii naatʼaʼí	Draco
Łeeyiʼ chʼosh bikágí ntłʼizí	Hippoidea
Gólízhii bíchį́į́h tʼáá łichíiʼii	Conepatus
Iichʼąhii naashchʼąąʼígíí	Chrysiridia rhipheus
Wóóseetsʼiniiniłhiní	Rhaphidophoridae
Ałchʼįʼ beʼastłʼóní	Tamal
Gólízhii yistłʼinígíí	Spilogale
Łóóʼchilí bitʼaʼ ádaadinígíí	Amphioxiformes
Biniiʼnoodǫ́zí (tsin yigázhígíí)	Lagostomus maximus
Tsísʼnátsoh diłhiłígíí	Xylocopa
Aniłtʼánii (bideeneezígíí)	Ascalaphidae
Shádiʼááhdę́ę́ʼ chʼoshtsoh bíláshgaantsohí	Parastacidae
Zábąąhnteelii (łóóʼ ooshgę́ęzhii)	Rhina ancylostoma
Gahjaaʼí bitseeneezígíí	Lagidium
Łitsooí (Yootó Hahoodzo)	Tierra Amarilla
Naaldlooshii Bikéshgaan Dahólónígíí	Ungulata
Nóódaʼí	Utes
Táłkááʼ dilwoʼí yázhí	Veliidae
Néʼézhiin	Pic à nuque rouge
Ginítsoh diłhiłí	Buse noire
Hoshdódii	Engoulevent bois-pourri
Chʼééh digháhii bitsʼaʼ dah deezʼáhí	Graptemys
Táłtłááh chʼoshyog	Nereididae
Dlǫ́ʼii yił aheełtʼéhii diłhiłígíí	Galerella pulverulenta
Chʼosh bitsʼaʼ doolghasígíí	Pectinidae
Chaatʼíní bichʼosh	Gastrophysa viridula
Ndilkal biyaʼ noodǫ́zígíí	Chrysomèle rayée du concombre
Iichʼąhii bitʼaʼ ahéédiníʼáhí	Eumorpha achemon
Tádídíín yiyání łizhinígíí	Timarcha
Chʼałdą́ą́ʼ bichʼosh	Crioceris
Niʼbéshjah	Amorpha
Yéʼiitsoh Bidił Niníyęęzh	El Malpais National Monument
Tsékʼi Naʼasdzooí (Yootó Hahoodzo)	El Morro National Monument
Tsídii bidaatsoh naashchʼąąʼí	Ramphastidae
Chʼał bikéshgaan hólóní	Xenopus
Tó bichʼosh (ałchozhígíí)	Corixidae
Tó wónaanídę́ę́ʼ nahashchʼidí	Meles
Wónitłʼizí nahalinígíí	Glomerida
Nahashchʼidí yił aheełtʼéhii yázhí	Melogale
Dáánézí (łóóʼ)	Centriscidae
Tłʼiish bichóhí	Crotalus cerastes
Tsékʼi yaʼiiʼáhii	Sphinx du tabac
Táłkááʼ sikaadí	Céraiste des champs
Táłtłʼááh chʼosh chʼééh digháhii bitsiiʼ dikʼání	Cephalaspidea
Dahtooʼ yinooghałii	Troglodyte des marais
Chʼó bidághaaʼ	Usnea dasypoga
Tsédááʼii	Oribatida
Hastiin Pavao Skalić	Paul Scalich
Atʼaʼ éljołí nahalinígíí (táłtłʼááh chʼosh)	Sabellidae
Tʼááłáhági átʼéego:Bééshbichʼahí	Catégorie:Allemagne
Tʼááłáhági átʼéego:Wááshindoon bikéyah ałhidadiidzooígíí	Catégorie:États-Unis
Táłtłʼááh kʼaaʼ (łóóʼ)	Fistulariidae
Tʼááłáhági átʼéego:Dibé diníí bikéyah	Catégorie:Espagne
Tʼááłáhági átʼéego:Naakaii Bikéyah	Catégorie:Mexique
Nteelbitʼąąłánígíí	Iris missouriensis
Naalkʼįhí bizaʼazis hólóní	Petaurus
Wóódeʼełchíhii	Coreidae
Naʼashǫ́ʼii diwozhígíí	Smaug giganteus
Choozhghalii	Icterus
Tsinlátah mąʼii	Bassaricyon
Tsiiyah wozhii	Sturnella
Chʼóyáázh nahalinígíí (táłtłʼááh chʼosh)	Spirobranchus giganteus
Chʼosh dichiłí bitsʼaʼígíí	Mytiloida
Naatsédlózii	Geococcyx
Kʼįįʼ łitsooítsoh	Mahonia fremontii
Tʼááłáhági átʼéego:Bidił daazdoígíí dóó daʼałtʼoʼígíí	Catégorie:Mammifère
Tʼááłáhági átʼéego:Naaldlooshii dadichʼízhii	Catégorie:Reptile
Tʼááłáhági átʼéego:Biyáázh Tsʼǫʼasánígíí	Catégorie:Amphibien
Tʼááłáhági átʼéego:Tsídii	Catégorie:Oiseau
Tʼááłáhági átʼéego:Chʼosh doo yitʼíinii dláádí dóó Ábishjaaʼ	Catégorie:Fungi
Tʼááłáhági átʼéego:Chʼil	Catégorie:Plante
Tʼááłáhági átʼéego:Nátʼą́ą́ʼ náháneʼ	Catégorie:Histoire
Tʼááłáhági átʼéego:Naʼalkaah	Catégorie:Sciences
Béégashii bideetsohí	Watusi
Cháʼoł	Pin à pignons
Dził Nááyisí	Monts Sandia
Góóhníinii	Havasupai
Tsísʼná disxǫsígíí	Euglossini
Łóóʼtsoh bizábąąh shiyishí	Eubalaena
Tʼiis Názbąs	Teec Nos Pos
Kiisʼáanii Naakáí yikʼéʼ daʼdéísdlį́į́h	Révolte des Pueblos
Tsin bizęęs	Polyporus
Táłtłʼááh chʼosh chʼééh digháhii bikeeʼ nteelígíí	Naticidae
Dah yiskʼid	Terre-plein (architecture)
Táshchozhii ndiilkʼísii	Hirondelle à front blanc
Tsídiiłtsooiiłkizhígíí	Bruant de Baird
Neeshchʼííʼ biyaʼ	Hylobe
Hosh yiyání (níłtsą́goʼ)	Moneilema
Aniłtʼánii łibáhígíí	Nabidae
Wóótsʼóóz	Alydidae
Iichʼąhii	Hétérocères
Chʼoshtsoh yázhí bíláshgaantsohí	Galatheidae
Roman dinéʼiʼ	Rome antique
Maricopa dinéʼiʼ	Maricopas
Naadą́ą́ʼ bichʼosh	Chrysomèle des racines du maïs
Dlodziłgai bichʼil	Ipomopsis aggregata
Dził Bílátah Łitsooí	Sunset Crater Volcano National Monument
Azeeʼ ndootʼeezhí	Monarde ponctuée
Shádiʼááhdę́ę́ʼ tsékʼi dlǫ́ǫ́ʼ	Kerodon rupestris
Dziłíjiin	Black Mesa (Arizona)
Naabeehó	Nation navajo
Chʼoshtsoh bikágí diwozhí	Lithodidae
Tséʼnaa Naʼníʼáhí	Rainbow Bridge National Monument
Dilzhʼíʼ	Yavapais
Dáádílí ntsxaaígíí	Epinephelus itajara
Kégiizhí	Tohono O'odham
Chʼosh ałchozhii (iichʼąhii)	Mite des vêtements
Wóóchį́į́hnézí	Fulgoridae
Tsiitsʼiin łichíʼítsoh	Stenopelmatidae
Bitátʼahkin	Navajo National Monument
Tsintah bįįhchilí	Tragulus
Tʼiistsʼóóz	Peuplier à feuilles étroites
Tsékʼi naʼazólii	Sauromalus
Juan de Oñate	Juan de Oñate
Deezʼáahjįʼ	Walpi
Atsá	Aigle
Naʼashǫ́ʼiinteeltsxooí	Platysaurus imperator
Séíbéʼézhóóʼ	Muhlenbergia
Tsʼah	Artemisia tridentata
Dził Łigaii (Dibé Nitsaa Hahoodzo)	Monts San Juan
Tsé Bitʼaʼí	Shiprock
Naashtʼézhí (Yootó Hahoodzo)	Zuni Pueblo
Tséchʼil	Quercus gambelii
Ndilnaʼii	Paresseux
Tsísʼnáyázhí	Halictidae
Chʼałtʼą́hí	Pipa (amphibien)
Dą́ʼáchaan	Ustilago
Dził Bizhiʼ Ádiní	Monts Henry
Níłtsą́goʼ noodǫ́zígíí	Polyphylla decemlineata
Chʼil dilyésii	Gutierrezia
Iichʼąhiiłgai bitʼaʼnézí	Thysania agrippina
Tsézhįįh Deezlį́	Black Rock (Nouveau-Mexique)
Séí nahachagiichilí (chʼosh bikágí ntłʼizí)	Talitridae
Beeʼaghádaʼdildlaadí	Générateur de rayons X
Nátʼoh Dził	Plateau de Kaibab
Tsédédééh	Mirabilis multiflora
Jááłánii bitsiitsʼiin łichííʼígíí	Scolopendra heros
Azeeʼ hókánii	Potentilla gracilis
Tsą́ą́haltsʼaaʼ	Lepidium montanum
Dinastsoh	Arctostaphylos patula
Kʼaasdá bee yigą́	Eupatorium purpureum
Díkʼǫ́ǫ́zhízlíní	Atriplex confertifolia
Tłʼiish yiltsiiʼí	Penstemon palmeri
Niłtsínii	Arisaema triphyllum
Táłchaaʼ	Phyllophaga
Jááłánii noodǫ́zígíí	Scolopendra polymorpha
Jaaniłtsʼíliidą́ą́ʼ	Cheilanthes feei
Chąąʼinii	Rumex hymenosepalus
Chʼil łizhiní	Coleogyne ramosissima
Nááʼ łitsooí	Solanum elaeagnifolium
Tsétah dibé bichʼil	Erigeron divergens
Naʼashǫ́ʼiinteelí	Platysaurus intermedius
Tséʼézhííh	Artemisia ludoviciana
Tseelkǫǫhí (bizaʼazis hólónígíí)	Couscous (animal)
Tʼáá Bííchʼį́įdii (Áshįįh Biiʼtó Hahoodzo)	Aneth (Utah)
Narbona	Narbona
Aniłtʼániitsoh	Corydalinae
Kʼíneedlíshiidą́ą́ʼ	Abronia fragrans
Naʼashǫ́ʼiidą́ą́ʼ	Asclepias subverticillata
Tłʼoh nástasí	Bouteloua aristidoides
Áłchínídą́ą́ʼ (chʼil)	Calochortus nuttallii
Tʼááłáhági átʼéego:Stubs	Catégorie:Wikipédia:ébauche
Tʼááłáhági átʼéego:Chidí naatʼaʼí	Catégorie:Type d'aéronef
Tsékʼi naʼazólii yistłʼinígíí	Chuckwalla de San Esteban
Naʼashjéʼiidą́ą́ʼ	Croton texensis
Bįįh yiljaaʼí	Frasera speciosa
Yiltsiiʼígíí	Physaria fendleri
Azeetsoh	Erysimum capitatum
Áłchínítsoh (chʼil)	Tradescantia occidentalis
Hosh bee yildéhé	Senecio flaccidus
Tsʼahbįįh	Stanleya pinnata
Nahatʼeʼiidą́ą́ʼ łibáhígíí	Dimorphocarpa wislizeni
Nííʼiiʼnił ntsxaaígíí	Zinnia grandiflora
Niʼdiidlídii	Stipe à glumes membraneuses
Tłʼoh łichííʼ	Sorghastrum nutans
Tłʼiish kʼaaʼ beeʼiiłkóóh	Eremocrinum albomarginatum
Wóláchíídą́ą́ʼ hasooł	Eriogonum inflatum
Yilchʼozhʼazeeʼ	Lupinus lyallii
Azeeʼ shaazhí	Ranunculus cymbalaria
Diniʼeechʼil áłtsʼóózígíí	Linum lewisii
Náʼagéédí	Taupe
Bee álnééhí:User uk-2	Modèle:Utilisateur uk-2
Naadą́ą́ʼ biyaʼ	Sitophilus zeamais
Awéétsʼáál (chʼil)	Purshie tridentée
Akétłʼóól yigházhígíí (łéʼétsoh)	Rat des bambous
Tábąąsdísí	Bécassine (oiseau)
Łóóʼ biyaʼ (chʼosh bikágí ntłʼizí)	Argulus
Tʼááłáhági átʼéego:Wikipedia bots	Catégorie:Bot Wikipédia
Chooyin azeeʼ	Corydale dorée
Tónteel zhį́ʼii	Cormoran
Niłtsínii bikétłʼóól dijoolí (daadánígíí)	Navet
Tsídii bitseeʼ naashchʼąąʼí	Pavo
Bee álnééhí:Tl	Modèle:M
Tʼááłáhági átʼéego:Bee Hazʼáanii	Catégorie:Droit
Tʼááłáhági átʼéego:Kéyah daʼnaaznilígíí dóó kéyah biłhaʼdaʼhaasdzoígíí	Catégorie:Pays
Wikiibíídiiya:Dahwéetʼaahígíí	Wikipédia:Administrateur
Wikiibíídiiya:Botígíí beehazʼą́ąnii	Wikipédia:Bot
Ííjip	Égypte
Bee álnééhí:Bot	Modèle:Bot
Deeteel Bikéyah	Canada
Wikiibíídiiya:Baa haneʼ	Wikipédia:À propos
Tʼááłáhági átʼéego:Béésh bichʼahníí bikéyah	Catégorie:Pays d'Europe
Tʼááłáhági átʼéego:Choyoołʼįįhí Bizaad	Catégorie:Wikipédiens par langue
Anáʼálwoʼ:Wikiibíídiiya beehazʼą́ąnii	Wikipédia:Règles
Tséłnííʼjí (chʼil)	Capillaire de Montpellier
Bee álnééhí:Softredirect	Modèle:Redirection douce
Chʼosh chʼééh digháhii	Gastropoda
Tʼááłáhági átʼéego:Saad	Catégorie:Langue
Wikiibíídiiya:General disclaimer	Wikipédia:Avertissements généraux
Wikiibíídiiya:Statistics	Wikipédia:Statistiques
Tséʼésdaazí	Cercocarpe de montagne
Nahatʼeʼiitsoh	Kangourou
Łóóʼ hashkéhéchilí	Chimaeriformes
Tʼááłáhági átʼéego:Béésh bee akʼeʼelchíhí tʼáá bí nitsékeesígíí	Catégorie:Application de l'informatique
Naayízí (chʼil)	Courge
Bee álnééhí:!	Modèle:!
Bee álnééhí:Bots	Modèle:Bots
Tʼááłáhági átʼéego:Naaltsoos	Catégorie:Livre
Bee álnééhí:Wikisource	Modèle:Wikisource
Bee álnééhí:Babel	Modèle:Boîte Babel
Bee álnééhí:Commons	Modèle:Commons
Bee álnééhí:Reflist	Modèle:Références
Tábąąh mąʼii bíchį́į́h nineezí	Coati
Bee álnééhí:Stub	Modèle:Ébauche
Bee álnééhí:User af-1	Modèle:Utilisateur af-1
Bee álnééhí:User als-1	Modèle:Utilisateur als-1
Bee álnééhí:User ar-1	Modèle:Utilisateur ar-1
Bee álnééhí:User az	Modèle:Utilisateur az
Bee álnééhí:User bar-1	Modèle:Utilisateur bar-1
Bee álnééhí:User eo-1	Modèle:Utilisateur eo-1
Bee álnééhí:See also	Modèle:Article connexe
Bee álnééhí:User da-2	Modèle:Utilisateur da-2
Bee álnééhí:User da	Modèle:Utilisateur da
Bee álnééhí:User ca-1	Modèle:Utilisateur ca-1
Bee álnééhí:User ca-4	Modèle:Utilisateur ca-4
Bee álnééhí:User be-2	Modèle:Utilisateur be-2
Bee álnééhí:User da-1	Modèle:Utilisateur da-1
Bee álnééhí:User cs-1	Modèle:Utilisateur cs-1
Bee álnééhí:User bg-1	Modèle:Utilisateur bg-1
Bee álnééhí:User eo-3	Modèle:Utilisateur eo-3
Bee álnééhí:User de	Modèle:Utilisateur de
Bee álnééhí:User de-1	Modèle:Utilisateur de-1
Bee álnééhí:User eu-4	Modèle:Utilisateur eu-4
Bee álnééhí:User eu	Modèle:Utilisateur eu
Bee álnééhí:User et-1	Modèle:Utilisateur et-1
Bee álnééhí:User el	Modèle:Utilisateur el
Bee álnééhí:User es	Modèle:Utilisateur es
Bee álnééhí:User de-3	Modèle:Utilisateur de-3
Bee álnééhí:User en-3	Modèle:Utilisateur en-3
Bee álnééhí:User el-1	Modèle:Utilisateur el-1
Bee álnééhí:User en-1	Modèle:Utilisateur en-1
Bee álnééhí:User en-2	Modèle:Utilisateur en-2
Bee álnééhí:User fa-1	Modèle:Utilisateur fa-1
Bee álnééhí:User eo-2	Modèle:Utilisateur eo-2
Bee álnééhí:User en-4	Modèle:Utilisateur en-4
Bee álnééhí:User fi	Modèle:Utilisateur fi
Bee álnééhí:User en-0	Modèle:Utilisateur en-0
Bee álnééhí:User es-4	Modèle:Utilisateur es-4
Bee álnééhí:User en	Modèle:Utilisateur en
Bee álnééhí:User de-2	Modèle:Utilisateur de-2
Bee álnééhí:User es-1	Modèle:Utilisateur es-1
Bee álnééhí:User fa	Modèle:Utilisateur fa
Bee álnééhí:User fi-1	Modèle:Utilisateur fi-1
Bee álnééhí:User fr-1	Modèle:Utilisateur fr-1
Bee álnééhí:User ia-2	Modèle:Utilisateur ia-2
Bee álnééhí:User hi-1	Modèle:Utilisateur hi-1
Bee álnééhí:User hr	Modèle:Utilisateur hr
Bee álnééhí:User he-2	Modèle:Utilisateur he-2
Bee álnééhí:User he-1	Modèle:Utilisateur he-1
Bee álnééhí:User hu	Modèle:Utilisateur hu
Bee álnééhí:User id-3	Modèle:Utilisateur id-3
Bee álnééhí:User io-3	Modèle:Utilisateur io-3
Bee álnééhí:User it-3	Modèle:Utilisateur it-3
Bee álnééhí:User grc-1	Modèle:Utilisateur grc-1
Bee álnééhí:User ja-4	Modèle:Utilisateur ja-4
Bee álnééhí:User sk	Modèle:Utilisateur sk
Bee álnééhí:User tr-2	Modèle:Utilisateur tr-2
Bee álnééhí:User fr-2	Modèle:Utilisateur fr-2
Bee álnééhí:User tr	Modèle:Utilisateur tr
Bee álnééhí:User ja	Modèle:Utilisateur ja
Bee álnééhí:User ja-1	Modèle:Utilisateur ja-1
Bee álnééhí:User it-1	Modèle:Utilisateur it-1
Bee álnééhí:User hr-1	Modèle:Utilisateur hr-1
Bee álnééhí:User fr	Modèle:Utilisateur fr
Bee álnééhí:User gsw-1	Modèle:Utilisateur gsw-1
Bee álnééhí:User he	Modèle:Utilisateur he
Tʼááłáhági átʼéego:Chʼosh bijáád hastánígíí	Catégorie:Insecte
Tʼááłáhági átʼéego:Choyoołʼįįhí uk	Catégorie:Utilisateur uk
Tʼááłáhági átʼéego:Choyoołʼįįhí uk-N	Catégorie:Utilisateur uk-M
Tʼááłáhági átʼéego:Chʼiyáán	Catégorie:Aliment
Bee álnééhí:User sv	Modèle:Utilisateur sv
Bee álnééhí:SIL	Modèle:Lien ISO 639-3
Bee álnééhí:User it	Modèle:Utilisateur it
Bee álnééhí:User uk	Modèle:Utilisateur uk
Bee álnééhí:User es-2	Modèle:Utilisateur es-2
Tʼááłáhági átʼéego:Choyoołʼįįhí ms	Catégorie:Utilisateur ms
Tʼááłáhági átʼéego:Choyoołʼįįhí fr-1	Catégorie:Utilisateur fr-1
Bee álnééhí:Image label	Modèle:Image label
Bee álnééhí:User ms	Modèle:Utilisateur ms
Tʼááłáhági átʼéego:Atsá dóó Giní Ndahalinígíí	Catégorie:Falconiformes
Bee álnééhí:User hi-3	Modèle:Utilisateur hi-3
Tʼááłáhági átʼéego:Choyoołʼįįhí en-4	Catégorie:Utilisateur en-4
Tʼááłáhági átʼéego:Choyoołʼįįhí en	Catégorie:Utilisateur en
Tʼááłáhági átʼéego:Choyoołʼįįhí zh	Catégorie:Utilisateur zh
Tʼááłáhági átʼéego:Choyoołʼįįhí zh-N	Catégorie:Utilisateur zh-M
Tʼááłáhági átʼéego:Choyoołʼįįhí en-2	Catégorie:Utilisateur en-2
Bee álnééhí:User eo	Modèle:Utilisateur eo
Bee álnééhí:User zh	Modèle:Utilisateur zh
Bee álnééhí:User ru-4	Modèle:Utilisateur ru-4
Bee álnééhí:User sr	Modèle:Utilisateur sr
Bee álnééhí:GeoTemplate	Modèle:GeoTemplate
Bee álnééhí:User nl-1	Modèle:Utilisateur nl-1
Bee álnééhí:User nl-2	Modèle:Utilisateur nl-2
Tʼááłáhági átʼéego:Choyoołʼįįhí hi	Catégorie:Utilisateur hi
Tʼááłáhági átʼéego:Choyoołʼįįhí ms-N	Catégorie:Utilisateur ms-M
Tʼááłáhági átʼéego:Dził	Catégorie:Montagne
Bee álnééhí:User ru	Modèle:Utilisateur ru
Tʼááłáhági átʼéego:Kéyah yádiłhił biiʼ dahólónígíí	Catégorie:Planète du système solaire
Tʼááłáhági átʼéego:Kéyah dah siʼánígíí	Catégorie:Amérique
Tʼááłáhági átʼéego:Choyoołʼįįhí bizaad-Templates	Catégorie:Langue pour les boîtes utilisateurs
Bee álnééhí:Archive	Modèle:Archives
Bee álnééhí:User eo-4	Modèle:Utilisateur eo-4
Tʼááłáhági átʼéego:Siláołtsooí	Catégorie:Armée
Tʼááłáhági átʼéego:Naʼashǫ́ʼii	Catégorie:Saurien
Bee álnééhí:User pt-1	Modèle:Utilisateur pt-1
Bee álnééhí:Tb	Modèle:Réponse
Bee álnééhí:Pt elements	Modèle:Tableau périodique (navigation)
Bee álnééhí:User oc-4	Modèle:Utilisateur oc-4
Bee álnééhí:User pl	Modèle:Utilisateur pl
Bee álnééhí:User nl	Modèle:Utilisateur nl
Bee álnééhí:User no-2	Modèle:Utilisateur no-2
Bee álnééhí:Image label end	Modèle:Image label fin
Bee álnééhí:Userpage	Modèle:Page personnelle
Bee álnééhí:Emergency-bot-shutoff	Modèle:Arrêt d'urgence pour bot
Bee álnééhí:User pl-1	Modèle:Utilisateur pl-1
Bee álnééhí:Image label small	Modèle:Image label small
Bee álnééhí:User fr-3	Modèle:Utilisateur fr-3
Bee álnééhí:User lt	Modèle:Utilisateur lt
Bee álnééhí:User nds-1	Modèle:Utilisateur nds-1
Tʼááłáhági átʼéego:Hosh	Catégorie:Cactaceae
Díłdánii (Ałtsʼáʼáztiin)	Caille
Bee álnééhí:User tr-4	Modèle:Utilisateur tr-4
Bee álnééhí:User is-1	Modèle:Utilisateur is-1
Bee álnééhí:User is-2	Modèle:Utilisateur is-2
Bee álnééhí:User ar-2	Modèle:Utilisateur ar-2
Bee álnééhí:User ar-3	Modèle:Utilisateur ar-3
Bee álnééhí:User is	Modèle:Utilisateur is
Bee álnééhí:User ar	Modèle:Utilisateur ar
Bee álnééhí:User az-3	Modèle:Utilisateur az-3
Bee álnééhí:User en-5	Modèle:Utilisateur en-5
Tʼááłáhági átʼéego:Choyoołʼįįhí ja-N	Catégorie:Utilisateur ja-M
Bee álnééhí:User als	Modèle:Utilisateur als
Bee álnééhí:@	Modèle:@
Tʼááłáhági átʼéego:Tłʼoh	Catégorie:Poaceae
Bee álnééhí:Ałtsʼáʼáztiin	Modèle:Homonymie
Bee álnééhí:User no-3	Modèle:Utilisateur no-3
Bee álnééhí:User ksh	Modèle:Utilisateur ksh
Bee álnééhí:User no	Modèle:Utilisateur no
Bee álnééhí:User yue-1	Modèle:Utilisateur zh-yue-1
Bee álnééhí:User sv-2	Modèle:Utilisateur sv-2
Bee álnééhí:User it-2	Modèle:Utilisateur it-2
Tʼááłáhági átʼéego:Ásáí Bikéyah	Catégorie:Pays du monde arabe
Tʼááłáhági átʼéego:Kǫʼ naʼałbąąsii	Catégorie:Chemin de fer
Bee álnééhí:User pt-3	Modèle:Utilisateur pt-3
Bee álnééhí:User pt-2	Modèle:Utilisateur pt-2
Bee álnééhí:User th-1	Modèle:Utilisateur th-1
Bee álnééhí:User lb-1	Modèle:Utilisateur lb-1
Bee álnééhí:User ro-4	Modèle:Utilisateur ro-4
Bee álnééhí:User ro	Modèle:Utilisateur ro
Bee álnééhí:User hy-4	Modèle:Utilisateur hy-4
Bee álnééhí:User fr-4	Modèle:Utilisateur fr-4
Bee álnééhí:User lv	Modèle:Utilisateur lv
Bee álnééhí:User bg	Modèle:Utilisateur bg
Tʼááłáhági átʼéego:Choyoołʼįįhí vi-3	Catégorie:Utilisateur vi-3
Bee álnééhí:User la-1	Modèle:Utilisateur la-1
Tʼááłáhági átʼéego:Templates/doc	Catégorie:Documentation de modèle
Tʼááłáhági átʼéego:Choyoołʼįįhí bjn	Catégorie:Utilisateur bjn
Tʼááłáhági átʼéego:Choyoołʼįįhí yue	Catégorie:Utilisateur zh-yue
Tʼááłáhági átʼéego:Choyoołʼįįhí pdc	Catégorie:Utilisateur pdc
Tʼááłáhági átʼéego:Choyoołʼįįhí mzn	Catégorie:Utilisateur mzn
Tʼááłáhági átʼéego:Choyoołʼįįhí at	Catégorie:Utilisateur de-at
Tʼááłáhági átʼéego:Choyoołʼįįhí az	Catégorie:Utilisateur az
Tʼááłáhági átʼéego:Choyoołʼįįhí be	Catégorie:Utilisateur be
Tʼááłáhági átʼéego:Choyoołʼįįhí nb-N	Catégorie:Utilisateur nb-M
Tʼááłáhági átʼéego:Choyoołʼįįhí bs	Catégorie:Utilisateur bs
Tʼááłáhági átʼéego:Choyoołʼįįhí ce	Catégorie:Utilisateur ce
Tʼááłáhági átʼéego:Choyoołʼįįhí chr	Catégorie:Utilisateur chr
Tʼááłáhági átʼéego:Choyoołʼįįhí hr	Catégorie:Utilisateur hr
Tʼááłáhági átʼéego:Choyoołʼįįhí sk	Catégorie:Utilisateur sk
Tʼááłáhági átʼéego:Choyoołʼįįhí sl	Catégorie:Utilisateur sl
Tʼááłáhági átʼéego:Choyoołʼįįhí eo	Catégorie:Utilisateur eo
Tʼááłáhági átʼéego:Choyoołʼįįhí et	Catégorie:Utilisateur et
Tʼááłáhági átʼéego:Choyoołʼįįhí fr	Catégorie:Utilisateur fr
Tʼááłáhági átʼéego:Choyoołʼįįhí frr	Catégorie:Utilisateur frr
Tʼááłáhági átʼéego:Choyoołʼįįhí gl	Catégorie:Utilisateur gl
Tʼááłáhági átʼéego:Choyoołʼįįhí cy	Catégorie:Utilisateur cy
Tʼááłáhági átʼéego:Choyoołʼįįhí gn	Catégorie:Utilisateur gn
Tʼááłáhági átʼéego:Choyoołʼįįhí hu-N	Catégorie:Utilisateur hu-M
Tʼááłáhági átʼéego:Choyoołʼįįhí id	Catégorie:Utilisateur id
Tʼááłáhági átʼéego:Choyoołʼįįhí ia	Catégorie:Utilisateur ia
Tʼááłáhági átʼéego:Choyoołʼįįhí ga	Catégorie:Utilisateur ga
Tʼááłáhági átʼéego:Choyoołʼįįhí ja	Catégorie:Utilisateur ja
Tʼááłáhági átʼéego:Choyoołʼįįhí km	Catégorie:Utilisateur km
Tʼááłáhági átʼéego:Choyoołʼįįhí la	Catégorie:Utilisateur la
Tʼááłáhági átʼéego:Choyoołʼįįhí li	Catégorie:Utilisateur li
Tʼááłáhági átʼéego:Choyoołʼįįhí lt	Catégorie:Utilisateur lt
Tʼááłáhági átʼéego:Choyoołʼįįhí mk	Catégorie:Utilisateur mk
Tʼááłáhági átʼéego:Choyoołʼįįhí mg	Catégorie:Utilisateur mg
Tʼááłáhági átʼéego:Choyoołʼįįhí mwl	Catégorie:Utilisateur mwl
Tʼááłáhági átʼéego:Choyoołʼįįhí mn	Catégorie:Utilisateur mn
Tʼááłáhági átʼéego:Choyoołʼįįhí nn	Catégorie:Utilisateur nn
Tʼááłáhági átʼéego:Choyoołʼįįhí nah	Catégorie:Utilisateur nah
Tʼááłáhági átʼéego:Choyoołʼįįhí oc	Catégorie:Utilisateur oc
Tʼááłáhági átʼéego:Choyoołʼįįhí pt	Catégorie:Utilisateur pt
Tʼááłáhági átʼéego:Choyoołʼįįhí ro	Catégorie:Utilisateur ro
Tʼááłáhági átʼéego:Choyoołʼįįhí sc	Catégorie:Utilisateur sc
Tʼááłáhági átʼéego:Choyoołʼįįhí sh	Catégorie:Utilisateur sh
Tʼááłáhági átʼéego:Choyoołʼįįhí sv	Catégorie:Utilisateur sv
Tʼááłáhági átʼéego:Choyoołʼįįhí sw	Catégorie:Utilisateur sw
Tʼááłáhági átʼéego:Choyoołʼįįhí sa	Catégorie:Utilisateur sa
Tʼááłáhági átʼéego:Choyoołʼįįhí th	Catégorie:Utilisateur th
Tʼááłáhági átʼéego:Choyoołʼįįhí ta	Catégorie:Utilisateur ta
Tʼááłáhági átʼéego:Choyoołʼįįhí vo	Catégorie:Utilisateur vo
Tʼááłáhági átʼéego:Choyoołʼįįhí bar-3	Catégorie:Utilisateur bar-3
Tʼááłáhági átʼéego:Choyoołʼįįhí az-3	Catégorie:Utilisateur az-3
Tʼááłáhági átʼéego:Choyoołʼįįhí be-3	Catégorie:Utilisateur be-3
Tʼááłáhági átʼéego:Choyoołʼįįhí cs-3	Catégorie:Utilisateur cs-3
Tʼááłáhági átʼéego:Choyoołʼįįhí sl-3	Catégorie:Utilisateur sl-3
Tʼááłáhági átʼéego:Choyoołʼįįhí et-3	Catégorie:Utilisateur et-3
Tʼááłáhági átʼéego:Choyoołʼįįhí fr-3	Catégorie:Utilisateur fr-3
Tʼááłáhági átʼéego:Choyoołʼįįhí cy-3	Catégorie:Utilisateur cy-3
Tʼááłáhági átʼéego:Choyoołʼįįhí gn-3	Catégorie:Utilisateur gn-3
Tʼááłáhági átʼéego:Choyoołʼįįhí hi-3	Catégorie:Utilisateur hi-3
Tʼááłáhági átʼéego:Choyoołʼįįhí ia-3	Catégorie:Utilisateur ia-3
Tʼááłáhági átʼéego:Choyoołʼįįhí it-3	Catégorie:Utilisateur it-3
Tʼááłáhági átʼéego:Choyoołʼįįhí ja-3	Catégorie:Utilisateur ja-3
Tʼááłáhági átʼéego:Choyoołʼįįhí li-3	Catégorie:Utilisateur li-3
Tʼááłáhági átʼéego:Choyoołʼįįhí lt-3	Catégorie:Utilisateur lt-3
Tʼááłáhági átʼéego:Choyoołʼįįhí mk-3	Catégorie:Utilisateur mk-3
Tʼááłáhági átʼéego:Choyoołʼįįhí nl-3	Catégorie:Utilisateur nl-3
Tʼááłáhági átʼéego:Choyoołʼįįhí no-3	Catégorie:Utilisateur no-3
Tʼááłáhági átʼéego:Choyoołʼįįhí nah-3	Catégorie:Utilisateur nah-3
Tʼááłáhági átʼéego:Choyoołʼįįhí oc-3	Catégorie:Utilisateur oc-3
Tʼááłáhági átʼéego:Choyoołʼįįhí pl-3	Catégorie:Utilisateur pl-3
Tʼááłáhági átʼéego:Choyoołʼįįhí sh-3	Catégorie:Utilisateur sh-3
Tʼááłáhági átʼéego:Choyoołʼįįhí sw-3	Catégorie:Utilisateur sw-3
Tʼááłáhági átʼéego:Choyoołʼįįhí sa-3	Catégorie:Utilisateur sa-3
Tʼááłáhági átʼéego:Choyoołʼįįhí ta-3	Catégorie:Utilisateur ta-3
Tʼááłáhági átʼéego:Choyoołʼįįhí tr-3	Catégorie:Utilisateur tr-3
Tʼááłáhági átʼéego:Choyoołʼįįhí ar-3	Catégorie:Utilisateur ar-3
Tʼááłáhági átʼéego:Choyoołʼįįhí an-1	Catégorie:Utilisateur an-1
Tʼááłáhági átʼéego:Choyoołʼįįhí be-1	Catégorie:Utilisateur be-1
Tʼááłáhági átʼéego:Choyoołʼįįhí cs-1	Catégorie:Utilisateur cs-1
Tʼááłáhági átʼéego:Choyoołʼįįhí da-1	Catégorie:Utilisateur da-1
Tʼááłáhági átʼéego:Choyoołʼįįhí sl-1	Catégorie:Utilisateur sl-1
Tʼááłáhági átʼéego:Choyoołʼįįhí et-1	Catégorie:Utilisateur et-1
Tʼááłáhági átʼéego:Choyoołʼįįhí fi-1	Catégorie:Utilisateur fi-1
Tʼááłáhági átʼéego:Choyoołʼįįhí cy-1	Catégorie:Utilisateur cy-1
Tʼááłáhági átʼéego:Choyoołʼįįhí gn-1	Catégorie:Utilisateur gn-1
Tʼááłáhági átʼéego:Choyoołʼįįhí hi-1	Catégorie:Utilisateur hi-1
Tʼááłáhági átʼéego:Choyoołʼįįhí ia-1	Catégorie:Utilisateur ia-1
Tʼááłáhági átʼéego:Choyoołʼįįhí ga-1	Catégorie:Utilisateur ga-1
Tʼááłáhági átʼéego:Choyoołʼįįhí jv-1	Catégorie:Utilisateur jv-1
Tʼááłáhági átʼéego:Choyoołʼįįhí ku-1	Catégorie:Utilisateur ku-1
Tʼááłáhági átʼéego:Choyoołʼįįhí lv-1	Catégorie:Utilisateur lv-1
Tʼááłáhági átʼéego:Choyoołʼįįhí li-1	Catégorie:Utilisateur li-1
Tʼááłáhági átʼéego:Choyoołʼįįhí lt-1	Catégorie:Utilisateur lt-1
Tʼááłáhági átʼéego:Choyoołʼįįhí mk-1	Catégorie:Utilisateur mk-1
Tʼááłáhági átʼéego:Choyoołʼįįhí nl-1	Catégorie:Utilisateur nl-1
Tʼááłáhági átʼéego:Choyoołʼįįhí nah-1	Catégorie:Utilisateur nah-1
Tʼááłáhági átʼéego:Choyoołʼįįhí oc-1	Catégorie:Utilisateur oc-1
Tʼááłáhági átʼéego:Choyoołʼįįhí pl-1	Catégorie:Utilisateur pl-1
Tʼááłáhági átʼéego:Choyoołʼįįhí ro-1	Catégorie:Utilisateur ro-1
Tʼááłáhági átʼéego:Choyoołʼįįhí sc-1	Catégorie:Utilisateur sc-1
Tʼááłáhági átʼéego:Choyoołʼįįhí sh-1	Catégorie:Utilisateur sh-1
Tʼááłáhági átʼéego:Choyoołʼįįhí sw-1	Catégorie:Utilisateur sw-1
Tʼááłáhági átʼéego:Choyoołʼįįhí sa-1	Catégorie:Utilisateur sa-1
Tʼááłáhági átʼéego:Choyoołʼįįhí tr-1	Catégorie:Utilisateur tr-1
Tʼááłáhági átʼéego:Choyoołʼįįhí vo-1	Catégorie:Utilisateur vo-1
Tʼááłáhági átʼéego:Choyoołʼįįhí ar-1	Catégorie:Utilisateur ar-1
Tʼááłáhági átʼéego:Choyoołʼįįhí be-4	Catégorie:Utilisateur be-4
Tʼááłáhági átʼéego:Choyoołʼįįhí cs-4	Catégorie:Utilisateur cs-4
Tʼááłáhági átʼéego:Choyoołʼįįhí ko-4	Catégorie:Utilisateur ko-4
Tʼááłáhági átʼéego:Choyoołʼįįhí sl-4	Catégorie:Utilisateur sl-4
Tʼááłáhági átʼéego:Choyoołʼįįhí et-4	Catégorie:Utilisateur et-4
Tʼááłáhági átʼéego:Choyoołʼįįhí fr-4	Catégorie:Utilisateur fr-4
Tʼááłáhági átʼéego:Choyoołʼįįhí cy-4	Catégorie:Utilisateur cy-4
Tʼááłáhági átʼéego:Choyoołʼįįhí gn-4	Catégorie:Utilisateur gn-4
Tʼááłáhági átʼéego:Choyoołʼįįhí hi-4	Catégorie:Utilisateur hi-4
Tʼááłáhági átʼéego:Choyoołʼįįhí hu-4	Catégorie:Utilisateur hu-4
Tʼááłáhági átʼéego:Choyoołʼįįhí id-4	Catégorie:Utilisateur id-4
Tʼááłáhági átʼéego:Choyoołʼįįhí ia-4	Catégorie:Utilisateur ia-4
Tʼááłáhági átʼéego:Choyoołʼįįhí it-4	Catégorie:Utilisateur it-4
Tʼááłáhági átʼéego:Choyoołʼįįhí li-4	Catégorie:Utilisateur li-4
Tʼááłáhági átʼéego:Choyoołʼįįhí lt-4	Catégorie:Utilisateur lt-4
Tʼááłáhági átʼéego:Choyoołʼįįhí mk-4	Catégorie:Utilisateur mk-4
Tʼááłáhági átʼéego:Choyoołʼįįhí nah-4	Catégorie:Utilisateur nah-4
Tʼááłáhági átʼéego:Choyoołʼįįhí oc-4	Catégorie:Utilisateur oc-4
Tʼááłáhági átʼéego:Choyoołʼįįhí pl-4	Catégorie:Utilisateur pl-4
Tʼááłáhági átʼéego:Choyoołʼįįhí sh-4	Catégorie:Utilisateur sh-4
Tʼááłáhági átʼéego:Choyoołʼįįhí sw-4	Catégorie:Utilisateur sw-4
Tʼááłáhági átʼéego:Choyoołʼįįhí ar-4	Catégorie:Utilisateur ar-4
Tʼááłáhági átʼéego:Choyoołʼįįhí als-2	Catégorie:Utilisateur als-2
Tʼááłáhági átʼéego:Choyoołʼįįhí mzn-2	Catégorie:Utilisateur mzn-2
Tʼááłáhági átʼéego:Choyoołʼįįhí be-2	Catégorie:Utilisateur be-2
Tʼááłáhági átʼéego:Choyoołʼįįhí bs-2	Catégorie:Utilisateur bs-2
Tʼááłáhági átʼéego:Choyoołʼįįhí ce-2	Catégorie:Utilisateur ce-2
Tʼááłáhági átʼéego:Choyoołʼįįhí cs-2	Catégorie:Utilisateur cs-2
Tʼááłáhági átʼéego:Choyoołʼįįhí da-2	Catégorie:Utilisateur da-2
Tʼááłáhági átʼéego:Choyoołʼįįhí sk-2	Catégorie:Utilisateur sk-2
Tʼááłáhági átʼéego:Choyoołʼįįhí sl-2	Catégorie:Utilisateur sl-2
Tʼááłáhági átʼéego:Choyoołʼįįhí et-2	Catégorie:Utilisateur et-2
Tʼááłáhági átʼéego:Choyoołʼįįhí fr-2	Catégorie:Utilisateur fr-2
Tʼááłáhági átʼéego:Choyoołʼįįhí cy-2	Catégorie:Utilisateur cy-2
Tʼááłáhági átʼéego:Choyoołʼįįhí gn-2	Catégorie:Utilisateur gn-2
Tʼááłáhági átʼéego:Choyoołʼįįhí hi-2	Catégorie:Utilisateur hi-2
Tʼááłáhági átʼéego:Choyoołʼįįhí hu-2	Catégorie:Utilisateur hu-2
Tʼááłáhági átʼéego:Choyoołʼįįhí ia-2	Catégorie:Utilisateur ia-2
Tʼááłáhági átʼéego:Choyoołʼįįhí it-2	Catégorie:Utilisateur it-2
Tʼááłáhági átʼéego:Choyoołʼįįhí ja-2	Catégorie:Utilisateur ja-2
Tʼááłáhági átʼéego:Choyoołʼįįhí la-2	Catégorie:Utilisateur la-2
Tʼááłáhági átʼéego:Choyoołʼįįhí li-2	Catégorie:Utilisateur li-2
Tʼááłáhági átʼéego:Choyoołʼįįhí lt-2	Catégorie:Utilisateur lt-2
Tʼááłáhági átʼéego:Choyoołʼįįhí mk-2	Catégorie:Utilisateur mk-2
Tʼááłáhági átʼéego:Choyoołʼįįhí mwl-2	Catégorie:Utilisateur mwl-2
Tʼááłáhági átʼéego:Choyoołʼįįhí nl-2	Catégorie:Utilisateur nl-2
Tʼááłáhági átʼéego:Choyoołʼįįhí nah-2	Catégorie:Utilisateur nah-2
Tʼááłáhági átʼéego:Choyoołʼįįhí oc-2	Catégorie:Utilisateur oc-2
Tʼááłáhági átʼéego:Choyoołʼįįhí pl-2	Catégorie:Utilisateur pl-2
Tʼááłáhági átʼéego:Choyoołʼįįhí sh-2	Catégorie:Utilisateur sh-2
Tʼááłáhági átʼéego:Choyoołʼįįhí sv-2	Catégorie:Utilisateur sv-2
Tʼááłáhági átʼéego:Choyoołʼįįhí sw-2	Catégorie:Utilisateur sw-2
Tʼááłáhági átʼéego:Choyoołʼįįhí sa-2	Catégorie:Utilisateur sa-2
Tʼááłáhági átʼéego:Choyoołʼįįhí tr-2	Catégorie:Utilisateur tr-2
Tʼááłáhági átʼéego:Choyoołʼįįhí vo-2	Catégorie:Utilisateur vo-2
Tʼááłáhági átʼéego:Choyoołʼįįhí ar-2	Catégorie:Utilisateur ar-2
Tʼááłáhági átʼéego:Choyoołʼįįhí bjn-N	Catégorie:Utilisateur bjn-M
Tʼááłáhági átʼéego:Choyoołʼįįhí at-N	Catégorie:Utilisateur de-at-M
Tʼááłáhági átʼéego:Choyoołʼįįhí an-N	Catégorie:Utilisateur an-M
Tʼááłáhági átʼéego:Choyoołʼįįhí hy-N	Catégorie:Utilisateur hy-M
Tʼááłáhági átʼéego:Choyoołʼįįhí ast-N	Catégorie:Utilisateur ast-M
Tʼááłáhági átʼéego:Choyoołʼįįhí be-N	Catégorie:Utilisateur be-M
Tʼááłáhági átʼéego:Choyoołʼįįhí cs-N	Catégorie:Utilisateur cs-M
Tʼááłáhági átʼéego:Choyoołʼįįhí chr-N	Catégorie:Utilisateur chr-M
Tʼááłáhági átʼéego:Choyoołʼįįhí ko-N	Catégorie:Utilisateur ko-M
Tʼááłáhági átʼéego:Choyoołʼįįhí hr-N	Catégorie:Utilisateur hr-M
Tʼááłáhági átʼéego:Choyoołʼįįhí sl-N	Catégorie:Utilisateur sl-M
Tʼááłáhági átʼéego:Choyoołʼįįhí et-N	Catégorie:Utilisateur et-M
Tʼááłáhági átʼéego:Choyoołʼįįhí fr-N	Catégorie:Utilisateur fr-M
Tʼááłáhági átʼéego:Choyoołʼįįhí fy-N	Catégorie:Utilisateur fy-M
Tʼááłáhági átʼéego:Choyoołʼįįhí gl-N	Catégorie:Utilisateur gl-M
Tʼááłáhági átʼéego:Choyoołʼįįhí cy-N	Catégorie:Utilisateur cy-M
Tʼááłáhági átʼéego:Choyoołʼįįhí gn-N	Catégorie:Utilisateur gn-M
Tʼááłáhági átʼéego:Choyoołʼįįhí hi-N	Catégorie:Utilisateur hi-M
Tʼááłáhági átʼéego:Choyoołʼįįhí id-N	Catégorie:Utilisateur id-M
Tʼááłáhági átʼéego:Choyoołʼįįhí ia-N	Catégorie:Utilisateur ia-M
Tʼááłáhági átʼéego:Choyoołʼįįhí is-N	Catégorie:Utilisateur is-M
Tʼááłáhági átʼéego:Choyoołʼįįhí it-N	Catégorie:Utilisateur it-M
Tʼááłáhági átʼéego:Choyoołʼįįhí jv-N	Catégorie:Utilisateur jv-M
Tʼááłáhági átʼéego:Choyoołʼįįhí ku-N	Catégorie:Utilisateur ku-M
Tʼááłáhági átʼéego:Choyoołʼįįhí lv-N	Catégorie:Utilisateur lv-M
Tʼááłáhági átʼéego:Choyoołʼįįhí li-N	Catégorie:Utilisateur li-M
Tʼááłáhági átʼéego:Choyoołʼįįhí lt-N	Catégorie:Utilisateur lt-M
Tʼááłáhági átʼéego:Choyoołʼįįhí lb-N	Catégorie:Utilisateur lb-M
Tʼááłáhági átʼéego:Choyoołʼįįhí mk-N	Catégorie:Utilisateur mk-M
Tʼááłáhági átʼéego:Choyoołʼįįhí mg-N	Catégorie:Utilisateur mg-M
Tʼááłáhági átʼéego:Choyoołʼįįhí nl-N	Catégorie:Utilisateur nl-M
Tʼááłáhági átʼéego:Choyoołʼįįhí no-N	Catégorie:Utilisateur no-M
Tʼááłáhági átʼéego:Choyoołʼįįhí nn-N	Catégorie:Utilisateur nn-M
Tʼááłáhági átʼéego:Choyoołʼįįhí nah-N	Catégorie:Utilisateur nah-M
Tʼááłáhági átʼéego:Choyoołʼįįhí oc-N	Catégorie:Utilisateur oc-M
Tʼááłáhági átʼéego:Choyoołʼįįhí or-N	Catégorie:Utilisateur or-M
Tʼááłáhági átʼéego:Choyoołʼįįhí ru-N	Catégorie:Utilisateur ru-M
Tʼááłáhági átʼéego:Choyoołʼįįhí sh-N	Catégorie:Utilisateur sh-M
Tʼááłáhági átʼéego:Choyoołʼįįhí sw-N	Catégorie:Utilisateur sw-M
Tʼááłáhági átʼéego:Choyoołʼįįhí sa-N	Catégorie:Utilisateur sa-M
Tʼááłáhági átʼéego:Choyoołʼįįhí ta-N	Catégorie:Utilisateur ta-M
Tʼááłáhági átʼéego:Choyoołʼįįhí ar-N	Catégorie:Utilisateur ar-M
Bee álnééhí:User yue	Modèle:Utilisateur yüt
Tʼááłáhági átʼéego:Choyoołʼįįhí eu-3	Catégorie:Utilisateur eu-3
Tʼááłáhági átʼéego:Choyoołʼįįhí eu-N	Catégorie:Utilisateur eu-M
Tʼááłáhági átʼéego:Choyoołʼįįhí af	Catégorie:Utilisateur af
Tʼááłáhági átʼéego:Choyoołʼįįhí af-1	Catégorie:Utilisateur af-1
Tʼááłáhági átʼéego:Choyoołʼįįhí af-2	Catégorie:Utilisateur af-2
Tʼááłáhági átʼéego:Choyoołʼįįhí af-3	Catégorie:Utilisateur af-3
Tʼááłáhági átʼéego:Choyoołʼįįhí af-4	Catégorie:Utilisateur af-4
Tʼááłáhági átʼéego:Choyoołʼįįhí af-N	Catégorie:Utilisateur af-M
Tʼááłáhági átʼéego:Choyoołʼįįhí als	Catégorie:Utilisateur als
Tʼááłáhági átʼéego:Choyoołʼįįhí als-1	Catégorie:Utilisateur als-1
Tʼááłáhági átʼéego:Choyoołʼįįhí an	Catégorie:Utilisateur an
Tʼááłáhági átʼéego:Choyoołʼįįhí ar	Catégorie:Utilisateur ar
Tʼááłáhági átʼéego:Choyoołʼįįhí as	Catégorie:Utilisateur as
Tʼááłáhági átʼéego:Choyoołʼįįhí as-N	Catégorie:Utilisateur as-M
Tʼááłáhági átʼéego:Choyoołʼįįhí ast	Catégorie:Utilisateur ast
Tʼááłáhági átʼéego:Choyoołʼįįhí ay	Catégorie:Utilisateur ay
Tʼááłáhági átʼéego:Choyoołʼįįhí ay-1	Catégorie:Utilisateur ay-1
Tʼááłáhági átʼéego:Choyoołʼįįhí ay-4	Catégorie:Utilisateur ay-4
Tʼááłáhági átʼéego:Choyoołʼįįhí az-1	Catégorie:Utilisateur az-1
Tʼááłáhági átʼéego:Choyoołʼįįhí az-2	Catégorie:Utilisateur az-2
Tʼááłáhági átʼéego:Choyoołʼįįhí az-4	Catégorie:Utilisateur az-4
Tʼááłáhági átʼéego:Choyoołʼįįhí az-N	Catégorie:Utilisateur az-M
Tʼááłáhági átʼéego:Choyoołʼįįhí ba	Catégorie:Utilisateur ba
Tʼááłáhági átʼéego:Choyoołʼįįhí ba-1	Catégorie:Utilisateur ba-1
Tʼááłáhági átʼéego:Choyoołʼįįhí ba-2	Catégorie:Utilisateur ba-2
Tʼááłáhági átʼéego:Choyoołʼįįhí bar	Catégorie:Utilisateur bar
Tʼááłáhági átʼéego:Choyoołʼįįhí bar-1	Catégorie:Utilisateur bar-1
Tʼááłáhági átʼéego:Choyoołʼįįhí bar-2	Catégorie:Utilisateur bar-2
Tʼááłáhági átʼéego:Choyoołʼįįhí bar-4	Catégorie:Utilisateur bar-4
Tʼááłáhági átʼéego:Choyoołʼįįhí bar-N	Catégorie:Utilisateur bar-M
Tʼááłáhági átʼéego:Choyoołʼįįhí bg	Catégorie:Utilisateur bg
Tʼááłáhági átʼéego:Choyoołʼįįhí bg-1	Catégorie:Utilisateur bg-1
Tʼááłáhági átʼéego:Choyoołʼįįhí bg-2	Catégorie:Utilisateur bg-2
Tʼááłáhági átʼéego:Choyoołʼįįhí bg-3	Catégorie:Utilisateur bg-3
Tʼááłáhági átʼéego:Choyoołʼįįhí bg-4	Catégorie:Utilisateur bg-4
Tʼááłáhági átʼéego:Choyoołʼįįhí bg-N	Catégorie:Utilisateur bg-M
Tʼááłáhági átʼéego:Choyoołʼįįhí bn	Catégorie:Utilisateur bn
Tʼááłáhági átʼéego:Choyoołʼįįhí bn-2	Catégorie:Utilisateur bn-2
Tʼááłáhági átʼéego:Choyoołʼįįhí bn-N	Catégorie:Utilisateur bn-M
Tʼááłáhági átʼéego:Choyoołʼįįhí ca	Catégorie:Utilisateur ca
Tʼááłáhági átʼéego:Choyoołʼįįhí ca-1	Catégorie:Utilisateur ca-1
Tʼááłáhági átʼéego:Choyoołʼįįhí ca-2	Catégorie:Utilisateur ca-2
Tʼááłáhági átʼéego:Tádídíín deiyání	Catégorie:Chrysomelidae
Tʼááłáhági átʼéego:Choyoołʼįįhí ca-3	Catégorie:Utilisateur ca-3
Tʼááłáhági átʼéego:Choyoołʼįįhí ca-4	Catégorie:Utilisateur ca-4
Tʼááłáhági átʼéego:Choyoołʼįįhí ca-N	Catégorie:Utilisateur ca-M
Tʼááłáhági átʼéego:Choyoołʼįįhí ce-3	Catégorie:Utilisateur ce-3
Tʼááłáhági átʼéego:Choyoołʼįįhí ce-N	Catégorie:Utilisateur ce-M
Tʼááłáhági átʼéego:Choyoołʼįįhí chr-1	Catégorie:Utilisateur chr-1
Tʼááłáhági átʼéego:Choyoołʼįįhí chr-2	Catégorie:Utilisateur chr-2
Tʼááłáhági átʼéego:Choyoołʼįįhí cr	Catégorie:Utilisateur cr
Tʼááłáhági átʼéego:Choyoołʼįįhí cr-1	Catégorie:Utilisateur cr-1
Tʼááłáhági átʼéego:Choyoołʼįįhí cs	Catégorie:Utilisateur cs
Tʼááłáhági átʼéego:Choyoołʼįįhí csb	Catégorie:Utilisateur csb
Tʼááłáhági átʼéego:Choyoołʼįįhí csb-1	Catégorie:Utilisateur csb-1
Tʼááłáhági átʼéego:Choyoołʼįįhí da	Catégorie:Utilisateur da
Tʼááłáhági átʼéego:Choyoołʼįįhí sk-N	Catégorie:Utilisateur sk-M
Tʼááłáhági átʼéego:Choyoołʼįįhí da-3	Catégorie:Utilisateur da-3
Tʼááłáhági átʼéego:Choyoołʼįįhí da-4	Catégorie:Utilisateur da-4
Tʼááłáhági átʼéego:Choyoołʼįįhí de	Catégorie:Utilisateur de
Tʼááłáhági átʼéego:Choyoołʼįįhí de-2	Catégorie:Utilisateur de-2
Tʼááłáhági átʼéego:Choyoołʼįįhí de-3	Catégorie:Utilisateur de-3
Tʼááłáhági átʼéego:Choyoołʼįįhí de-4	Catégorie:Utilisateur de-4
Tʼááłáhági átʼéego:Choyoołʼįįhí de-N	Catégorie:Utilisateur de-M
Tʼááłáhági átʼéego:Choyoołʼįįhí dsb	Catégorie:Utilisateur dsb
Tʼááłáhági átʼéego:Choyoołʼįįhí dsb-1	Catégorie:Utilisateur dsb-1
Tʼááłáhági átʼéego:Choyoołʼįįhí dsb-2	Catégorie:Utilisateur dsb-2
Tʼááłáhági átʼéego:Choyoołʼįįhí dsb-N	Catégorie:Utilisateur dsb-M
Tʼááłáhági átʼéego:Choyoołʼįįhí el	Catégorie:Utilisateur el
Tʼááłáhági átʼéego:Choyoołʼįįhí el-1	Catégorie:Utilisateur el-1
Tʼááłáhági átʼéego:Choyoołʼįįhí el-2	Catégorie:Utilisateur el-2
Tʼááłáhági átʼéego:Choyoołʼįįhí el-3	Catégorie:Utilisateur el-3
Tʼááłáhági átʼéego:Choyoołʼįįhí el-4	Catégorie:Utilisateur el-4
Tʼááłáhági átʼéego:Choyoołʼįįhí el-N	Catégorie:Utilisateur el-M
Tʼááłáhági átʼéego:Choyoołʼįįhí en-0	Catégorie:Utilisateur en-0
Tʼááłáhági átʼéego:Choyoołʼįįhí en-3	Catégorie:Utilisateur en-3
Tʼááłáhági átʼéego:Choyoołʼįįhí en-5	Catégorie:Utilisateur en-5
Tʼááłáhági átʼéego:Choyoołʼįįhí en-N	Catégorie:Utilisateur en-M
Tʼááłáhági átʼéego:Choyoołʼįįhí eo-1	Catégorie:Utilisateur eo-1
Tʼááłáhági átʼéego:Choyoołʼįįhí eo-2	Catégorie:Utilisateur eo-2
Tʼááłáhági átʼéego:Choyoołʼįįhí eo-3	Catégorie:Utilisateur eo-3
Tʼááłáhági átʼéego:Choyoołʼįįhí eo-4	Catégorie:Utilisateur eo-4
Tʼááłáhági átʼéego:Choyoołʼįįhí eo-N	Catégorie:Utilisateur eo-M
Tʼááłáhági átʼéego:Choyoołʼįįhí es	Catégorie:Utilisateur es
Tʼááłáhági átʼéego:Choyoołʼįįhí es-1	Catégorie:Utilisateur es-1
Tʼááłáhági átʼéego:Choyoołʼįįhí es-2	Catégorie:Utilisateur es-2
Tʼááłáhági átʼéego:Choyoołʼįįhí es-3	Catégorie:Utilisateur es-3
Tʼááłáhági átʼéego:Choyoołʼįįhí es-4	Catégorie:Utilisateur es-4
Bee álnééhí:User es-5	Modèle:Utilisateur es-5
Tʼááłáhági átʼéego:Choyoołʼįįhí es-N	Catégorie:Utilisateur es-M
Tʼááłáhági átʼéego:Choyoołʼįįhí eu	Catégorie:Utilisateur eu
Tʼááłáhági átʼéego:Choyoołʼįįhí eu-1	Catégorie:Utilisateur eu-1
Tʼááłáhági átʼéego:Choyoołʼįįhí eu-2	Catégorie:Utilisateur eu-2
Tʼááłáhági átʼéego:Choyoołʼįįhí eu-4	Catégorie:Utilisateur eu-4
Tʼááłáhági átʼéego:Choyoołʼįįhí fa	Catégorie:Utilisateur fa
Tʼááłáhági átʼéego:Choyoołʼįįhí fa-1	Catégorie:Utilisateur fa-1
Tʼááłáhági átʼéego:Choyoołʼįįhí fa-2	Catégorie:Utilisateur fa-2
Tʼááłáhági átʼéego:Choyoołʼįįhí fa-3	Catégorie:Utilisateur fa-3
Tʼááłáhági átʼéego:Choyoołʼįįhí fa-N	Catégorie:Utilisateur fa-M
Tʼááłáhági átʼéego:Choyoołʼįįhí fi	Catégorie:Utilisateur fi
Tʼááłáhági átʼéego:Choyoołʼįįhí fi-2	Catégorie:Utilisateur fi-2
Tʼááłáhági átʼéego:Gólízhii	Catégorie:Mephitidae
Tʼááłáhági átʼéego:Choyoołʼįįhí fi-3	Catégorie:Utilisateur fi-3
Tʼááłáhági átʼéego:Choyoołʼįįhí fi-4	Catégorie:Utilisateur fi-4
Tʼááłáhági átʼéego:Choyoołʼįįhí fi-N	Catégorie:Utilisateur fi-M
Tʼááłáhági átʼéego:Choyoołʼįįhí fy	Catégorie:Utilisateur fy
Tʼááłáhági átʼéego:Choyoołʼįįhí fy-1	Catégorie:Utilisateur fy-1
Tʼááłáhági átʼéego:Choyoołʼįįhí ga-2	Catégorie:Utilisateur ga-2
Tʼááłáhági átʼéego:Choyoołʼįįhí ga-3	Catégorie:Utilisateur ga-3
Tʼááłáhági átʼéego:Choyoołʼįįhí ga-4	Catégorie:Utilisateur ga-4
Tʼááłáhági átʼéego:Choyoołʼįįhí ga-N	Catégorie:Utilisateur ga-M
Tʼááłáhági átʼéego:Choyoołʼįįhí grc	Catégorie:Utilisateur grc
Tʼááłáhági átʼéego:Choyoołʼįįhí grc-1	Catégorie:Utilisateur grc-1
Tʼááłáhági átʼéego:Choyoołʼįįhí grc-2	Catégorie:Utilisateur grc-2
Tʼááłáhági átʼéego:Choyoołʼįįhí grc-3	Catégorie:Utilisateur grc-3
Tʼááłáhági átʼéego:Choyoołʼįįhí grc-4	Catégorie:Utilisateur grc-4
Tʼááłáhági átʼéego:Choyoołʼįįhí grc-N	Catégorie:Utilisateur grc-M
Tʼááłáhági átʼéego:Choyoołʼįįhí gsw	Catégorie:Utilisateur gsw
Tʼááłáhági átʼéego:Choyoołʼįįhí gsw-N	Catégorie:Utilisateur gsw-M
Tʼááłáhági átʼéego:Choyoołʼįįhí he	Catégorie:Utilisateur he
Tʼááłáhági átʼéego:Choyoołʼįįhí he-1	Catégorie:Utilisateur he-1
Tʼááłáhági átʼéego:Choyoołʼįįhí he-2	Catégorie:Utilisateur he-2
Tʼááłáhági átʼéego:Choyoołʼįįhí he-3	Catégorie:Utilisateur he-3
Tʼááłáhági átʼéego:Choyoołʼįįhí he-4	Catégorie:Utilisateur he-4
Tʼááłáhági átʼéego:Choyoołʼįįhí he-N	Catégorie:Utilisateur he-M
Tʼááłáhági átʼéego:Choyoołʼįįhí hr-1	Catégorie:Utilisateur hr-1
Tʼááłáhági átʼéego:Choyoołʼįįhí hr-2	Catégorie:Utilisateur hr-2
Tʼááłáhági átʼéego:Choyoołʼįįhí hr-3	Catégorie:Utilisateur hr-3
Tʼááłáhági átʼéego:Choyoołʼįįhí hr-4	Catégorie:Utilisateur hr-4
Tʼááłáhági átʼéego:Choyoołʼįįhí hsb	Catégorie:Utilisateur hsb
Tʼááłáhági átʼéego:Choyoołʼįįhí hsb-1	Catégorie:Utilisateur hsb-1
Tʼááłáhági átʼéego:Choyoołʼįįhí hsb-2	Catégorie:Utilisateur hsb-2
Tʼááłáhági átʼéego:Choyoołʼįįhí hsb-3	Catégorie:Utilisateur hsb-3
Tʼááłáhági átʼéego:Choyoołʼįįhí hu	Catégorie:Utilisateur hu
Tʼááłáhági átʼéego:Choyoołʼįįhí hu-1	Catégorie:Utilisateur hu-1
Tʼááłáhági átʼéego:Choyoołʼįįhí hu-3	Catégorie:Utilisateur hu-3
Tʼááłáhági átʼéego:Choyoołʼįįhí hy	Catégorie:Utilisateur hy
Tʼááłáhági átʼéego:Choyoołʼįįhí hy-1	Catégorie:Utilisateur hy-1
Tʼááłáhági átʼéego:Choyoołʼįįhí hy-2	Catégorie:Utilisateur hy-2
Tʼááłáhági átʼéego:Choyoołʼįįhí hy-3	Catégorie:Utilisateur hy-3
Tʼááłáhági átʼéego:Choyoołʼįįhí hy-4	Catégorie:Utilisateur hy-4
Tʼááłáhági átʼéego:Choyoołʼįįhí id-1	Catégorie:Utilisateur id-1
Tʼááłáhági átʼéego:Choyoołʼįįhí id-2	Catégorie:Utilisateur id-2
Tʼááłáhági átʼéego:Choyoołʼįįhí id-3	Catégorie:Utilisateur id-3
Tʼááłáhági átʼéego:Choyoołʼįįhí io	Catégorie:Utilisateur io
Tʼááłáhági átʼéego:Choyoołʼįįhí io-1	Catégorie:Utilisateur io-1
Tʼááłáhági átʼéego:Choyoołʼįįhí io-2	Catégorie:Utilisateur io-2
Tʼááłáhági átʼéego:Choyoołʼįįhí io-3	Catégorie:Utilisateur io-3
Tʼááłáhági átʼéego:Choyoołʼįįhí is	Catégorie:Utilisateur is
Tʼááłáhági átʼéego:Choyoołʼįįhí is-1	Catégorie:Utilisateur is-1
Tʼááłáhági átʼéego:Choyoołʼįįhí is-2	Catégorie:Utilisateur is-2
Tʼááłáhági átʼéego:Choyoołʼįįhí is-3	Catégorie:Utilisateur is-3
Tʼááłáhági átʼéego:Choyoołʼįįhí is-4	Catégorie:Utilisateur is-4
Tʼááłáhági átʼéego:Choyoołʼįįhí als-N	Catégorie:Utilisateur als-M
Bee álnééhí:User la-3	Modèle:Utilisateur la-3
Tʼááłáhági átʼéego:Choyoołʼįįhí pt-3	Catégorie:Utilisateur pt-3
Tʼááłáhági átʼéego:Choyoołʼįįhí pl-N	Catégorie:Utilisateur pl-M
Tʼááłáhági átʼéego:Choyoołʼįįhí pt-1	Catégorie:Utilisateur pt-1
Tʼááłáhági átʼéego:Choyoołʼįįhí ka-1	Catégorie:Utilisateur ka-1
Bee álnééhí:Hooʼááłígíí	Modèle:Utilisateur Wikipédia:Administrateur
Tʼááłáhági átʼéego:Choyoołʼįįhí it	Catégorie:Utilisateur it
Tʼááłáhági átʼéego:Choyoołʼįįhí it-1	Catégorie:Utilisateur it-1
Tʼááłáhági átʼéego:Choyoołʼįįhí ja-1	Catégorie:Utilisateur ja-1
Tʼááłáhági átʼéego:Choyoołʼįįhí jv	Catégorie:Utilisateur jv
Tʼááłáhági átʼéego:Choyoołʼįįhí jv-2	Catégorie:Utilisateur jv-2
Tʼááłáhági átʼéego:Choyoołʼįįhí jv-3	Catégorie:Utilisateur jv-3
Tʼááłáhági átʼéego:Choyoołʼįįhí ka	Catégorie:Utilisateur ka
Tʼááłáhági átʼéego:Choyoołʼįįhí ka-2	Catégorie:Utilisateur ka-2
Tʼááłáhági átʼéego:Choyoołʼįįhí ka-3	Catégorie:Utilisateur ka-3
Tʼááłáhági átʼéego:Choyoołʼįįhí ka-N	Catégorie:Utilisateur ka-M
Tʼááłáhági átʼéego:Choyoołʼįįhí kg	Catégorie:Utilisateur kg
Tʼááłáhági átʼéego:Choyoołʼįįhí kl	Catégorie:Utilisateur kl
Tʼááłáhági átʼéego:Choyoołʼįįhí kl-1	Catégorie:Utilisateur kl-1
Tʼááłáhági átʼéego:Choyoołʼįįhí kl-2	Catégorie:Utilisateur kl-2
Tʼááłáhági átʼéego:Choyoołʼįįhí kl-3	Catégorie:Utilisateur kl-3
Tʼááłáhági átʼéego:Choyoołʼįįhí kl-4	Catégorie:Utilisateur kl-4
Tʼááłáhági átʼéego:Choyoołʼįįhí kl-N	Catégorie:Utilisateur kl-M
Tʼááłáhági átʼéego:Choyoołʼįįhí km-1	Catégorie:Utilisateur km-1
Tʼááłáhági átʼéego:Choyoołʼįįhí km-2	Catégorie:Utilisateur km-2
Tʼááłáhági átʼéego:Choyoołʼįįhí km-3	Catégorie:Utilisateur km-3
Tʼááłáhági átʼéego:Choyoołʼįįhí km-N	Catégorie:Utilisateur km-M
Tʼááłáhági átʼéego:Choyoołʼįįhí kn	Catégorie:Utilisateur kn
Tʼááłáhági átʼéego:Choyoołʼįįhí kn-1	Catégorie:Utilisateur kn-1
Tʼááłáhági átʼéego:Choyoołʼįįhí ko	Catégorie:Utilisateur ko
Tʼááłáhági átʼéego:Wááshindoon bikéyah bił haʼdaʼhaasdzoígíí	Catégorie:État des États-Unis
Tʼááłáhági átʼéego:Choyoołʼįįhí ko-1	Catégorie:Utilisateur ko-1
Tʼááłáhági átʼéego:Choyoołʼįįhí ko-2	Catégorie:Utilisateur ko-2
Tʼááłáhági átʼéego:Choyoołʼįįhí ko-3	Catégorie:Utilisateur ko-3
Tʼááłáhági átʼéego:Choyoołʼįįhí ksh	Catégorie:Utilisateur ksh
Tʼááłáhági átʼéego:Choyoołʼįįhí ksh-1	Catégorie:Utilisateur ksh-1
Tʼááłáhági átʼéego:Choyoołʼįįhí ksh-2	Catégorie:Utilisateur ksh-2
Tʼááłáhági átʼéego:Choyoołʼįįhí ksh-3	Catégorie:Utilisateur ksh-3
Tʼááłáhági átʼéego:Choyoołʼįįhí ksh-4	Catégorie:Utilisateur ksh-4
Tʼááłáhági átʼéego:Choyoołʼįįhí ksh-N	Catégorie:Utilisateur ksh-M
Tʼááłáhági átʼéego:Choyoołʼįįhí ku	Catégorie:Utilisateur ku
Tʼááłáhági átʼéego:Choyoołʼįįhí ku-2	Catégorie:Utilisateur ku-2
Tʼááłáhági átʼéego:Choyoołʼįįhí ku-3	Catégorie:Utilisateur ku-3
Tʼááłáhági átʼéego:Choyoołʼįįhí ku-4	Catégorie:Utilisateur ku-4
Tʼááłáhági átʼéego:Choyoołʼįįhí la-1	Catégorie:Utilisateur la-1
Tʼááłáhági átʼéego:Choyoołʼįįhí la-3	Catégorie:Utilisateur la-3
Tʼááłáhági átʼéego:Choyoołʼįįhí la-4	Catégorie:Utilisateur la-4
Tʼááłáhági átʼéego:Choyoołʼįįhí la-N	Catégorie:Utilisateur la-M
Tʼááłáhági átʼéego:Choyoołʼįįhí lb	Catégorie:Utilisateur lb
Tʼááłáhági átʼéego:Choyoołʼįįhí lb-1	Catégorie:Utilisateur lb-1
Tʼááłáhági átʼéego:Choyoołʼįįhí lb-2	Catégorie:Utilisateur lb-2
Tʼááłáhági átʼéego:Choyoołʼįįhí lb-3	Catégorie:Utilisateur lb-3
Tʼááłáhági átʼéego:Choyoołʼįįhí lb-4	Catégorie:Utilisateur lb-4
Tʼááłáhági átʼéego:Dibé Nitsaa Hahoodzodi kin naaznilígíí	Catégorie:Localité du Colorado
Bee álnééhí:User sh	Modèle:Utilisateur sh
Tʼááłáhági átʼéego:Choyoołʼįįhí nn-2	Catégorie:Utilisateur nn-2
Bee álnééhí:User gl	Modèle:Utilisateur gl
Tʼááłáhági átʼéego:Choyoołʼįįhí ru-1	Catégorie:Utilisateur ru-1
Bee álnééhí:User af-4	Modèle:Utilisateur af-4
Yaaʼ bijáád hastánígíí	Phthiraptera
Bee álnééhí:User ta	Modèle:Utilisateur ta
Bee álnééhí:User sv-1	Modèle:Utilisateur sv-1
Tʼááłáhági átʼéego:Chʼil bikétłʼóól daadánígíí	Catégorie:Légume-racine
Tʼááłáhági átʼéego:Choyoołʼįįhí lv	Catégorie:Utilisateur lv
Tʼááłáhági átʼéego:Choyoołʼįįhí mn-1	Catégorie:Utilisateur mn-1
Tʼááłáhági átʼéego:Choyoołʼįįhí mn-2	Catégorie:Utilisateur mn-2
Tʼááłáhági átʼéego:Choyoołʼįįhí mn-3	Catégorie:Utilisateur mn-3
Tʼááłáhági átʼéego:Choyoołʼįįhí mn-N	Catégorie:Utilisateur mn-M
Tʼááłáhági átʼéego:Choyoołʼįįhí ms-1	Catégorie:Utilisateur ms-1
Nahasdzáán bimagnetic field	Champ magnétique terrestre
Tʼááłáhági átʼéego:Choyoołʼįįhí als-3	Catégorie:Utilisateur als-3
Bee álnééhí:User jv	Modèle:Utilisateur jv
Bee álnééhí:User id	Modèle:Utilisateur id
Tʼááłáhági átʼéego:Choyoołʼįįhí nds	Catégorie:Utilisateur nds
Tʼááłáhági átʼéego:Choyoołʼįįhí nds-1	Catégorie:Utilisateur nds-1
Tʼááłáhági átʼéego:Choyoołʼįįhí nds-2	Catégorie:Utilisateur nds-2
Tʼááłáhági átʼéego:Choyoołʼįįhí nds-3	Catégorie:Utilisateur nds-3
Tʼááłáhági átʼéego:Choyoołʼįįhí nds-4	Catégorie:Utilisateur nds-4
Tʼááłáhági átʼéego:Choyoołʼįįhí nds-N	Catégorie:Utilisateur nds-M
Tʼááłáhági átʼéego:Choyoołʼįįhí nds-nl	Catégorie:Utilisateur nds-nl
Bee álnééhí:User oc-1	Modèle:Utilisateur oc-1
Tʼááłáhági átʼéego:Choyoołʼįįhí es-5	Catégorie:Utilisateur es-5
Tʼááłáhági átʼéego:Kéyah Ałhidadiidzooígíí dóó Ahiih Yikaígíí	Catégorie:Organisation internationale
Tʼááłáhági átʼéego:Chʼosh bijáád dahólónígíí	Catégorie:Arthropode
Tʼááłáhági átʼéego:Kʼaalógii	Catégorie:Papillon (nom vernaculaire)
Tʼááłáhági átʼéego:Tó	Catégorie:Eau
Tʼááłáhági átʼéego:Tsáʼásziʼ dóó Noodah	Catégorie:Agavaceae (Cronquist)
Tʼááłáhági átʼéego:Bidił daazdoígíí dóó daʼalghałígíí	Catégorie:Carnivore
Tʼááłáhági átʼéego:Choyoołʼįįhí tt-N	Catégorie:Utilisateur tt-M
Tʼááłáhági átʼéego:Choyoołʼįįhí nn-1	Catégorie:Utilisateur nn-1
Tʼááłáhági átʼéego:Choyoołʼįįhí nb	Catégorie:Utilisateur nb
Bee álnééhí:User sw-1	Modèle:Utilisateur sw-1
Bee álnééhí:User ka-1	Modèle:Utilisateur ka-1
Bee álnééhí:User af	Modèle:Utilisateur af
Tʼááłáhági átʼéego:Naakaii Łizhiní Bikéyah	Catégorie:Pays d'Afrique
Bee álnééhí:User ka-3	Modèle:Utilisateur ka-3
Bee álnééhí:User da-3	Modèle:Utilisateur da-3
Bee álnééhí:User pt-4	Modèle:Utilisateur pt-4
Bee álnééhí:User grc-4	Modèle:Utilisateur grc-4
Bee álnééhí:User sl-3	Modèle:Utilisateur sl-3
Bee álnééhí:User ja-2	Modèle:Utilisateur ja-2
Bee álnééhí:User ko-2	Modèle:Utilisateur ko-2
Bee álnééhí:User ko-1	Modèle:Utilisateur ko-1
Bee álnééhí:User cs	Modèle:Utilisateur cs
Bee álnééhí:User ru-2	Modèle:Utilisateur ru-2
Bee álnééhí:User es-3	Modèle:Utilisateur es-3
Bee álnééhí:User ja-3	Modèle:Utilisateur ja-3
Bee álnééhí:User eu-1	Modèle:Utilisateur eu-1
Bee álnééhí:User ko-3	Modèle:Utilisateur ko-3
Tʼááłáhági átʼéego:Tsin bineestʼąʼ dadíkʼǫ́zhígíí	Catégorie:Citrus
Tʼááłáhági átʼéego:Choyoołʼįįhí pt-2	Catégorie:Utilisateur pt-2
Tʼááłáhági átʼéego:Choyoołʼįįhí pt-4	Catégorie:Utilisateur pt-4
Tʼááłáhági átʼéego:Choyoołʼįįhí pt-N	Catégorie:Utilisateur pt-M
Tʼááłáhági átʼéego:Choyoołʼįįhí qu	Catégorie:Utilisateur qu
Tʼááłáhági átʼéego:Choyoołʼįįhí qu-1	Catégorie:Utilisateur qu-1
Tʼááłáhági átʼéego:Choyoołʼįįhí qu-2	Catégorie:Utilisateur qu-2
Tʼááłáhági átʼéego:Choyoołʼįįhí qu-3	Catégorie:Utilisateur qu-3
Tʼááłáhági átʼéego:Choyoołʼįįhí qu-N	Catégorie:Utilisateur qu-M
Tʼááłáhági átʼéego:Choyoołʼįįhí ro-2	Catégorie:Utilisateur ro-2
Tʼááłáhági átʼéego:Choyoołʼįįhí ro-3	Catégorie:Utilisateur ro-3
Tʼááłáhági átʼéego:Choyoołʼįįhí ro-4	Catégorie:Utilisateur ro-4
Tʼááłáhági átʼéego:Choyoołʼįįhí ro-N	Catégorie:Utilisateur ro-M
Tʼááłáhági átʼéego:Choyoołʼįįhí ru	Catégorie:Utilisateur ru
Tʼááłáhági átʼéego:Choyoołʼįįhí ru-2	Catégorie:Utilisateur ru-2
Tʼááłáhági átʼéego:Choyoołʼįįhí ru-3	Catégorie:Utilisateur ru-3
Tʼááłáhági átʼéego:Choyoołʼįįhí ru-4	Catégorie:Utilisateur ru-4
Tʼááłáhági átʼéego:Choyoołʼįįhí sk-1	Catégorie:Utilisateur sk-1
Tʼááłáhági átʼéego:Choyoołʼįįhí sk-3	Catégorie:Utilisateur sk-3
Tʼááłáhági átʼéego:Choyoołʼįįhí sk-4	Catégorie:Utilisateur sk-4
Tʼááłáhági átʼéego:Choyoołʼįįhí sr	Catégorie:Utilisateur sr
Tʼááłáhági átʼéego:Choyoołʼįįhí sr-1	Catégorie:Utilisateur sr-1
Tʼááłáhági átʼéego:Choyoołʼįįhí sr-2	Catégorie:Utilisateur sr-2
Tʼááłáhági átʼéego:Choyoołʼįįhí sr-3	Catégorie:Utilisateur sr-3
Tʼááłáhági átʼéego:Choyoołʼįįhí sr-4	Catégorie:Utilisateur sr-4
Tʼááłáhági átʼéego:Choyoołʼįįhí sr-N	Catégorie:Utilisateur sr-M
Tʼááłáhági átʼéego:Choyoołʼįįhí stq	Catégorie:Utilisateur stq
Tʼááłáhági átʼéego:Choyoołʼįįhí stq-1	Catégorie:Utilisateur stq-1
Tʼááłáhági átʼéego:Choyoołʼįįhí sv-1	Catégorie:Utilisateur sv-1
Tʼááłáhági átʼéego:Choyoołʼįįhí sv-3	Catégorie:Utilisateur sv-3
Tʼááłáhági átʼéego:Choyoołʼįįhí sv-4	Catégorie:Utilisateur sv-4
Tʼááłáhági átʼéego:Choyoołʼįįhí sv-N	Catégorie:Utilisateur sv-M
Tʼááłáhági átʼéego:Choyoołʼįįhí swg	Catégorie:Utilisateur swg
Tʼááłáhági átʼéego:Choyoołʼįįhí swg-N	Catégorie:Utilisateur swg-M
Tʼááłáhági átʼéego:Choyoołʼįįhí sxu	Catégorie:Utilisateur sxu
Tʼááłáhági átʼéego:Choyoołʼįįhí sxu-1	Catégorie:Utilisateur sxu-1
Tʼááłáhági átʼéego:Choyoołʼįįhí sxu-2	Catégorie:Utilisateur sxu-2
Tʼááłáhági átʼéego:Choyoołʼįįhí sxu-3	Catégorie:Utilisateur sxu-3
Tʼááłáhági átʼéego:Choyoołʼįįhí ta-1	Catégorie:Utilisateur ta-1
Tʼááłáhági átʼéego:Choyoołʼįįhí ta-2	Catégorie:Utilisateur ta-2
Tʼááłáhági átʼéego:Choyoołʼįįhí th-1	Catégorie:Utilisateur th-1
Tʼááłáhági átʼéego:Choyoołʼįįhí th-2	Catégorie:Utilisateur th-2
Tʼááłáhági átʼéego:Choyoołʼįįhí th-3	Catégorie:Utilisateur th-3
Tʼááłáhági átʼéego:Choyoołʼįįhí th-N	Catégorie:Utilisateur th-M
Tʼááłáhági átʼéego:Choyoołʼįįhí tr	Catégorie:Utilisateur tr
Tʼááłáhági átʼéego:Choyoołʼįįhí tr-4	Catégorie:Utilisateur tr-4
Tʼááłáhági átʼéego:Choyoołʼįįhí tr-N	Catégorie:Utilisateur tr-M
Tʼááłáhági átʼéego:Choyoołʼįįhí tt	Catégorie:Utilisateur tt
Tʼááłáhági átʼéego:Choyoołʼįįhí tt-1	Catégorie:Utilisateur tt-1
Tʼááłáhági átʼéego:Choyoołʼįįhí tt-2	Catégorie:Utilisateur tt-2
Tʼááłáhági átʼéego:Choyoołʼįįhí tt-3	Catégorie:Utilisateur tt-3
Tʼááłáhági átʼéego:Choyoołʼįįhí tt-4	Catégorie:Utilisateur tt-4
Tʼááłáhági átʼéego:Choyoołʼįįhí uk-1	Catégorie:Utilisateur uk-1
Tʼááłáhági átʼéego:Choyoołʼįįhí uk-2	Catégorie:Utilisateur uk-2
Tʼááłáhági átʼéego:Choyoołʼįįhí uk-3	Catégorie:Utilisateur uk-3
Tʼááłáhági átʼéego:Choyoołʼįįhí uk-4	Catégorie:Utilisateur uk-4
Tʼááłáhági átʼéego:Choyoołʼįįhí vi	Catégorie:Utilisateur vi
Tʼááłáhági átʼéego:Choyoołʼįįhí vi-1	Catégorie:Utilisateur vi-1
Tʼááłáhági átʼéego:Choyoołʼįįhí vi-2	Catégorie:Utilisateur vi-2
Tʼááłáhági átʼéego:Choyoołʼįįhí vi-4	Catégorie:Utilisateur vi-4
Tʼááłáhági átʼéego:Choyoołʼįįhí vi-N	Catégorie:Utilisateur vi-M
Tʼááłáhági átʼéego:Choyoołʼįįhí vls	Catégorie:Utilisateur vls
Tʼááłáhági átʼéego:Choyoołʼįįhí vls-1	Catégorie:Utilisateur vls-1
Tʼááłáhági átʼéego:Choyoołʼįįhí vls-N	Catégorie:Utilisateur vls-M
Tʼááłáhági átʼéego:Choyoołʼįįhí yue-1	Catégorie:Utilisateur zh-yue-1
Tʼááłáhági átʼéego:Choyoołʼįįhí yue-2	Catégorie:Utilisateur zh-yue-2
Tʼááłáhági átʼéego:Choyoołʼįįhí yue-3	Catégorie:Utilisateur zh-yue-3
Tʼááłáhági átʼéego:Choyoołʼįįhí yue-4	Catégorie:Utilisateur zh-yue-4
Tʼááłáhági átʼéego:Choyoołʼįįhí yue-N	Catégorie:Utilisateur zh-yue-M
Bee álnééhí:User ro-1	Modèle:Utilisateur ro-1
Tʼááłáhági átʼéego:Tsin ííʼáhígíí	Catégorie:Arbre
Bee álnééhí:User th	Modèle:Utilisateur th
Bee álnééhí:User nds-2	Modèle:Utilisateur nds-2
Náshdóítsoh (Ałtsʼáʼáztiin)	Fauve
Bee álnééhí:User ca	Modèle:Utilisateur ca
Tʼááłáhági átʼéego:Mágí	Catégorie:Primates
Bee álnééhí:User sv-3	Modèle:Utilisateur sv-3
Bee álnééhí:User hy-1	Modèle:Utilisateur hy-1
Bee álnééhí:User hsb-1	Modèle:Utilisateur hsb-1
Bee álnééhí:User hsb	Modèle:Utilisateur hsb
Tʼááłáhági átʼéego:Naʼiiniʼ	Catégorie:Commerce
Bee álnééhí:User hsb-2	Modèle:Utilisateur hsb-2
Bee álnééhí:User af-3	Modèle:Utilisateur af-3
Tʼááłáhági átʼéego:Naaki góneʼ yéigo daʼahijoogą́ą́ʼ	Catégorie:Seconde Guerre mondiale
Bee álnééhí:User ms-1	Modèle:Utilisateur ms-1
Tʼááłáhági átʼéego:Mósí dóó Náshdóí	Catégorie:Felidae
Bee álnééhí:User nds	Modèle:Utilisateur nds
Tʼááłáhági átʼéego:Tó Kéyah Bináhaazyínígíí	Catégorie:État insulaire
Bee álnééhí:User ar-4	Modèle:Utilisateur ar-4
Bee álnééhí:User az-2	Modèle:Utilisateur az-2
Bee álnééhí:User be	Modèle:Utilisateur be
Bee álnééhí:User ca-2	Modèle:Utilisateur ca-2
Bee álnééhí:User ca-3	Modèle:Utilisateur ca-3
Bee álnééhí:User cs-3	Modèle:Utilisateur cs-3
Bee álnééhí:User da-4	Modèle:Utilisateur da-4
Bee álnééhí:User el-2	Modèle:Utilisateur el-2
Bee álnééhí:User et-3	Modèle:Utilisateur et-3
Bee álnééhí:User fa-2	Modèle:Utilisateur fa-2
Bee álnééhí:User fa-3	Modèle:Utilisateur fa-3
Bee álnééhí:User fa-4	Modèle:Utilisateur fa-4
Bee álnééhí:User fi-2	Modèle:Utilisateur fi-2
Bee álnééhí:User fi-3	Modèle:Utilisateur fi-3
Bee álnééhí:User ga-2	Modèle:Utilisateur ga-2
Bee álnééhí:User he-3	Modèle:Utilisateur he-3
Bee álnééhí:User he-4	Modèle:Utilisateur he-4
Bee álnééhí:User hu-1	Modèle:Utilisateur hu-1
Bee álnééhí:User hy	Modèle:Utilisateur hy
Bee álnééhí:User jv-1	Modèle:Utilisateur jv-1
Bee álnééhí:User ka	Modèle:Utilisateur ka
Bee álnééhí:User ko	Modèle:Utilisateur ko
Bee álnééhí:User ku	Modèle:Utilisateur ku
Bee álnééhí:User la-2	Modèle:Utilisateur la-2
Bee álnééhí:User lb-2	Modèle:Utilisateur lb-2
Bee álnééhí:User li-1	Modèle:Utilisateur li-1
Bee álnééhí:User li-3	Modèle:Utilisateur li-3
Bee álnééhí:User mk-1	Modèle:Utilisateur mk-1
Bee álnééhí:User nn-2	Modèle:Utilisateur nn-2
Bee álnééhí:User no-1	Modèle:Utilisateur no-1
Bee álnééhí:User pl-2	Modèle:Utilisateur pl-2
Bee álnééhí:User pt	Modèle:Utilisateur pt
Bee álnééhí:User ro-2	Modèle:Utilisateur ro-2
Bee álnééhí:User ru-1	Modèle:Utilisateur ru-1
Bee álnééhí:User sa-1	Modèle:Utilisateur sa-1
Bee álnééhí:User sk-1	Modèle:Utilisateur sk-1
Bee álnééhí:User sk-2	Modèle:Utilisateur sk-2
Bee álnééhí:User sk-3	Modèle:Utilisateur sk-3
Bee álnééhí:User sr-1	Modèle:Utilisateur sr-1
Bee álnééhí:User sxu-1	Modèle:Utilisateur sxu-1
Bee álnééhí:User tr-1	Modèle:Utilisateur tr-1
Bee álnééhí:User tr-3	Modèle:Utilisateur tr-3
Bee álnééhí:User uk-1	Modèle:Utilisateur uk-1
Bee álnééhí:User uk-4	Modèle:Utilisateur uk-4
Bee álnééhí:User vo-1	Modèle:Utilisateur vo-1
Bee álnééhí:User zh-1	Modèle:Utilisateur zh-1
Bee álnééhí:User zh-2	Modèle:Utilisateur zh-2
Bee álnééhí:User zh-3	Modèle:Utilisateur zh-3
Bee álnééhí:User zh-4	Modèle:Utilisateur zh-4
Tʼááłáhági átʼéego:Naakaii Łizhiní Bikéyahdę́ę́ʼ Ndaaldeehii	Catégorie:Faune en Afrique
Tʼááłáhági átʼéego:Hakʼazdi Ndaaldeehii	Catégorie:Faune en Arctique
Tʼááłáhági átʼéego:Choyoołʼįįhí nl	Catégorie:Utilisateur nl
Tʼááłáhági átʼéego:Choyoołʼįįhí nn-3	Catégorie:Utilisateur nn-3
Tʼááłáhági átʼéego:Choyoołʼįįhí no-1	Catégorie:Utilisateur no-1
Tʼááłáhági átʼéego:Choyoołʼįįhí no-2	Catégorie:Utilisateur no-2
Tʼááłáhági átʼéego:Choyoołʼįįhí no	Catégorie:Utilisateur no
Tʼááłáhági átʼéego:Choyoołʼįįhí pi-1	Catégorie:Utilisateur pi-1
Tʼááłáhági átʼéego:Choyoołʼįįhí nds-nl-1	Catégorie:Utilisateur nds-nl-1
Tʼááłáhági átʼéego:Choyoołʼįįhí zh-1	Catégorie:Utilisateur zh-1
Tʼááłáhági átʼéego:Choyoołʼįįhí zh-4	Catégorie:Utilisateur zh-4
Tʼááłáhági átʼéego:Choyoołʼįįhí zh-3	Catégorie:Utilisateur zh-3
Tʼááłáhági átʼéego:Choyoołʼįįhí zh-2	Catégorie:Utilisateur zh-2
Tʼááłáhági átʼéego:Chʼał	Catégorie:Anoure
Tʼááłáhági átʼéego:Mąʼii yił Ałhidanoolinígíí Yázhí	Catégorie:Procyonidae
Tʼááłáhági átʼéego:Dlǫ́ʼiitsoh Danilínígíí	Catégorie:Viverridae
Tʼááłáhági átʼéego:Chéłchaaʼ	Catégorie:Coleoptera
Tʼááłáhági átʼéego:Naakáí dootłʼizhí dóó Bééshbichʼahii dabizaad ndahalinígíí	Catégorie:Langue indo-européenne
Tʼááłáhági átʼéego:Hazéí	Catégorie:Sciuridae
Tʼááłáhági átʼéego:Chidí naatʼaʼí ńdinibįįhígi	Catégorie:Aéroport
Tʼááłáhági átʼéego:Áʼádaatʼéhígíí	Catégorie:Élément chimique
Bee álnééhí:User als-2	Modèle:Utilisateur als-2
Bee álnééhí:User als-4	Modèle:Utilisateur als-4
Tʼááłáhági átʼéego:Mósí Danilínígíí	Catégorie:Felis
Tʼááłáhági átʼéego:Articles by class	Catégorie:Article par avancement
Bee álnééhí:User de-4	Modèle:Utilisateur de-4
Tʼááłáhági átʼéego:Biwooʼ Ádaałtsʼíísígíí dóó Kááʼtsʼiní	Catégorie:Xenarthra
Chʼoshtsoh bíláshgaantsohí (tónílį́įgiʼígíí)	Astacoidea
Tʼááłáhági átʼéego:Abeʼ bitsʼą́ą́dóó ádaalyaaígíí	Catégorie:Produit laitier
Tʼááłáhági átʼéego:Tsin dóó chʼil bineestʼąʼ	Catégorie:Fruit alimentaire
Tʼááłáhági átʼéego:Kʼaalógii dóó Iichʼąhii	Catégorie:Lepidoptera
Tʼááłáhági átʼéego:Chʼosh bijáád ádaadinígíí	Catégorie:Mollusque
Tʼááłáhági átʼéego:Deeteel Bikéyah bił haʼdaʼhaasdzoígíí	Catégorie:Province ou territoire canadien
Tʼááłáhági átʼéego:Gáagii dóó Joogii Ndahalinígíí	Catégorie:Corvidae
Tʼááłáhági átʼéego:Mąʼii dóó Łééchąąʼí	Catégorie:Canidae
Tʼááłáhági átʼéego:Tó Wónaanídę́ę́ʼ Mágí	Catégorie:Cercopithecidae
Tʼááłáhági átʼéego:Naayízí dóó taʼneeskʼání	Catégorie:Cucurbitaceae
Tʼááłáhági átʼéego:Dlǫ́ʼii Ndahalinígíí	Catégorie:Mustelidae
Tʼááłáhági átʼéego:Łóóʼtsoh biwooʼ dantłʼizígíí	Catégorie:Odontoceti
Tʼááłáhági átʼéego:Łóóʼtsoh biwooʼ daditsʼózígíí	Catégorie:Mysticeti
Tʼááłáhági átʼéego:Naaldeehii	Catégorie:Animal
Tʼááłáhági átʼéego:Shádiʼááhdę́ę́ʼ Ndaaldeehii	Catégorie:Faune en Amérique du Sud
Tʼááłáhági átʼéego:Bizaʼazis Dahólónígíí	Catégorie:Marsupialia
Tʼááłáhági átʼéego:Chʼosh chʼééh diikáhii	Catégorie:Gastéropode
Tʼááłáhági átʼéego:Chʼosh bitsʼaʼígíí	Catégorie:Bivalvia
Tʼááłáhági átʼéego:Gah	Catégorie:Lagomorphe
Tʼááłáhági átʼéego:Łóóʼtsoh dóó Tééh hóyáanii	Catégorie:Cétacé
Bee álnééhí:User bn	Modèle:Utilisateur bn
Bee álnééhí:User jv-2	Modèle:Utilisateur jv-2
Bee álnééhí:User fy-1	Modèle:Utilisateur fy-1
Bee álnééhí:User id-4	Modèle:Utilisateur id-4
Bee álnééhí:User uk-3	Modèle:Utilisateur uk-3
Bee álnééhí:User bn-2	Modèle:Utilisateur bn-2
Tʼááłáhági átʼéego:Eʼeʼaahjí Tónteel bikáaʼgi Kéyah dah Ndaaʼeełígíí	Catégorie:Île de l'océan Pacifique
Tʼááłáhági átʼéego:Łóóʼ Bigaan Dahólónígíí	Catégorie:Céphalopode
Tʼááłáhági átʼéego:Chʼééh digháhii dóó Tsisteeł	Catégorie:Testudines
Dah diníilghaazh	Frybread
Tʼááłáhági átʼéego:Béésh	Catégorie:Métal
Tʼááłáhági átʼéego:Naayééʼ	Catégorie:Dinosaure
Tʼááłáhági átʼéego:Choyoołʼįįhí pi	Catégorie:Utilisateur pi
Tʼááłáhági átʼéego:Choyoołʼįįhí pl	Catégorie:Utilisateur pl
Tʼááłáhági átʼéego:Choyoołʼįįhí th-4	Catégorie:Utilisateur th-4
Tʼááłáhági átʼéego:Chʼosh bikágí dantłʼizí	Catégorie:Crustacé
Tʼááłáhági átʼéego:Jaaʼabaní	Catégorie:Chiroptera
Tʼááłáhági átʼéego:Tłʼiish	Catégorie:Serpent
Tʼááłáhági átʼéego:Shádiʼááhjí kéyah yistinígíí	Catégorie:Antarctique
Tʼááłáhági átʼéego:Beʼekʼid	Catégorie:Lac
Kʼíshíshjį́į́zh	Sumac grimpant
Bee álnééhí:User sl	Modèle:Utilisateur sl
Bee álnééhí:User nn-4	Modèle:Utilisateur nn-4
Tʼááłáhági átʼéego:Bįįh	Catégorie:Cervidae
Bee álnééhí:User sw-3	Modèle:Utilisateur sw-3
Tʼááłáhági átʼéego:Łóóʼ hashkéhé	Catégorie:Requin
Tʼááłáhági átʼéego:Łóóʼ ooshgę́ęzhii	Catégorie:Chondrichthyes
Bee álnééhí:User hsb-3	Modèle:Utilisateur hsb-3
Tʼááłáhági átʼéego:Chidí	Catégorie:Automobile
Bee álnééhí:User ga-1	Modèle:Utilisateur ga-1
Bee álnééhí:User lb	Modèle:Utilisateur lb
Bee álnééhí:User af-2	Modèle:Utilisateur af-2
Chąąshtʼezhiitsoh	Carotte
Tséyooʼáałii	Curculionidae
Tʼááłáhági átʼéego:Łį́į́ʼ Ndahalinígíí	Catégorie:Equidae
Tʼááłáhági átʼéego:Naabeehó	Catégorie:Nation navajo
Tʼááłáhági átʼéego:Wóʼatsʼǫǫsii Ádaatʼéhígíí	Catégorie:Hemiptera
Tʼááłáhági átʼéego:Choyoołʼįįhí ta-4	Catégorie:Utilisateur ta-4
Tʼááłáhági átʼéego:Tsin Deigházhígíí	Catégorie:Rongeur
Bee álnééhí:User hr-2	Modèle:Utilisateur hr-2
Bee álnééhí:User sl-1	Modèle:Utilisateur sl-1
Tʼááłáhági átʼéego:Choyoołʼįįhí ab	Catégorie:Utilisateur ab
Tʼááłáhági átʼéego:Choyoołʼįįhí ab-3	Catégorie:Utilisateur ab-3
Tʼááłáhági átʼéego:Choyoołʼįįhí ab-N	Catégorie:Utilisateur ab-M
Tʼááłáhági átʼéego:Choyoołʼįįhí ka-4	Catégorie:Utilisateur ka-4
Bee álnééhí:User pl-3	Modèle:Utilisateur pl-3
Bee álnééhí:User pl-4	Modèle:Utilisateur pl-4
Bee álnééhí:User an-1	Modèle:Utilisateur an-1
Bee álnééhí:User vo-4	Modèle:Utilisateur vo-4
Bee álnééhí:User vo-3	Modèle:Utilisateur vo-3
Bee álnééhí:User vo-2	Modèle:Utilisateur vo-2
Bee álnééhí:User vo	Modèle:Utilisateur vo
Bee álnééhí:User vi-4	Modèle:Utilisateur vi-4
Bee álnééhí:User vi-2	Modèle:Utilisateur vi-2
Bee álnééhí:User vi-1	Modèle:Utilisateur vi-1
Bee álnééhí:User tt-3	Modèle:Utilisateur tt-3
Bee álnééhí:User tt-2	Modèle:Utilisateur tt-2
Bee álnééhí:User tt-1	Modèle:Utilisateur tt-1
Bee álnééhí:User ta-3	Modèle:Utilisateur ta-3
Bee álnééhí:User ta-1	Modèle:Utilisateur ta-1
Bee álnééhí:User swg	Modèle:Utilisateur swg-*
Bee álnééhí:User sw	Modèle:Utilisateur sw
Bee álnééhí:User stq-1	Modèle:Utilisateur stq-1
Bee álnééhí:User sr-4	Modèle:Utilisateur sr-4
Bee álnééhí:User sr-3	Modèle:Utilisateur sr-3
Bee álnééhí:User sr-2	Modèle:Utilisateur sr-2
Bee álnééhí:User sl-2	Modèle:Utilisateur sl-2
Bee álnééhí:User sh-4	Modèle:Utilisateur sh-4
Bee álnééhí:User sh-3	Modèle:Utilisateur sh-3
Bee álnééhí:User sh-1	Modèle:Utilisateur sh-1
Bee álnééhí:User sc-1	Modèle:Utilisateur sc-1
Bee álnééhí:User sa-3	Modèle:Utilisateur sa-3
Bee álnééhí:User qu-3	Modèle:Utilisateur qu-3
Bee álnééhí:User qu-2	Modèle:Utilisateur qu-2
Bee álnééhí:User qu-1	Modèle:Utilisateur qu-1
Bee álnééhí:User oc-3	Modèle:Utilisateur oc-3
Bee álnééhí:User oc-2	Modèle:Utilisateur oc-2
Bee álnééhí:User oc	Modèle:Utilisateur oc
Bee álnééhí:User nds-3	Modèle:Utilisateur nds-3
Bee álnééhí:User nah-3	Modèle:Utilisateur nah-3
Bee álnééhí:User nah-2	Modèle:Utilisateur nah-2
Bee álnééhí:User nah-1	Modèle:Utilisateur nah-1
Bee álnééhí:User mn-4	Modèle:Utilisateur mn-4
Bee álnééhí:User mn-3	Modèle:Utilisateur mn-3
Bee álnééhí:User mn-2	Modèle:Utilisateur mn-2
Bee álnééhí:User mn-1	Modèle:Utilisateur mn-1
Bee álnééhí:User mn	Modèle:Utilisateur mn
Bee álnééhí:User mk-3	Modèle:Utilisateur mk-3
Bee álnééhí:User mk-2	Modèle:Utilisateur mk-2
Bee álnééhí:User mk	Modèle:Utilisateur mk
Bee álnééhí:User mg	Modèle:Utilisateur mg
Bee álnééhí:User lv-1	Modèle:Utilisateur lv-1
Bee álnééhí:User lt-4	Modèle:Utilisateur lt-4
Bee álnééhí:User lt-3	Modèle:Utilisateur lt-3
Bee álnééhí:User lt-1	Modèle:Utilisateur lt-1
Bee álnééhí:User li-2	Modèle:Utilisateur li-2
Bee álnééhí:User lb-4	Modèle:Utilisateur lb-4
Bee álnééhí:User lb-3	Modèle:Utilisateur lb-3
Bee álnééhí:User la-4	Modèle:Utilisateur la-4
Bee álnééhí:User la	Modèle:Utilisateur la
Bee álnééhí:User ku-4	Modèle:Utilisateur ku-4
Bee álnééhí:User ku-3	Modèle:Utilisateur ku-3
Bee álnééhí:User ku-2	Modèle:Utilisateur ku-2
Bee álnééhí:User ku-1	Modèle:Utilisateur ku-1
Bee álnééhí:User ksh-4	Modèle:Utilisateur ksh-4
Bee álnééhí:User ksh-3	Modèle:Utilisateur ksh-3
Bee álnééhí:User ksh-2	Modèle:Utilisateur ksh-2
Bee álnééhí:User ksh-1	Modèle:Utilisateur ksh-1
Bee álnééhí:User ka-2	Modèle:Utilisateur ka-2
Bee álnééhí:User jv-3	Modèle:Utilisateur jv-3
Bee álnééhí:User it-4	Modèle:Utilisateur it-4
Bee álnééhí:User is-4	Modèle:Utilisateur is-4
Bee álnééhí:User is-3	Modèle:Utilisateur is-3
Bee álnééhí:User io-2	Modèle:Utilisateur io-2
Bee álnééhí:User io-1	Modèle:Utilisateur io-1
Bee álnééhí:User id-2	Modèle:Utilisateur id-2
Bee álnééhí:User ia-3	Modèle:Utilisateur ia-3
Bee álnééhí:User ia-1	Modèle:Utilisateur ia-1
Bee álnééhí:User ia	Modèle:Utilisateur ia
Bee álnééhí:User hr-3	Modèle:Utilisateur hr-3
Bee álnééhí:User hi-4	Modèle:Utilisateur hi-4
Bee álnééhí:User hi-2	Modèle:Utilisateur hi-2
Bee álnééhí:User grc-3	Modèle:Utilisateur grc-3
Bee álnééhí:User grc-2	Modèle:Utilisateur grc-2
Bee álnééhí:User grc	Modèle:Utilisateur grc
Bee álnééhí:User gn-2	Modèle:Utilisateur gn-2
Bee álnééhí:User ga	Modèle:Utilisateur ga
Bee álnééhí:User fi-4	Modèle:Utilisateur fi-4
Bee álnééhí:User et-4	Modèle:Utilisateur et-4
Bee álnééhí:User et-2	Modèle:Utilisateur et-2
Bee álnééhí:User et	Modèle:Utilisateur et
Bee álnééhí:User el-4	Modèle:Utilisateur el-4
Bee álnééhí:User el-3	Modèle:Utilisateur el-3
Bee álnééhí:User dsb-2	Modèle:Utilisateur dsb-2
Bee álnééhí:User dsb	Modèle:Utilisateur dsb
Bee álnééhí:User cy-3	Modèle:Utilisateur cy-3
Bee álnééhí:User cy-2	Modèle:Utilisateur cy-2
Bee álnééhí:User cy-1	Modèle:Utilisateur cy-1
Bee álnééhí:User cy	Modèle:Utilisateur cy
Bee álnééhí:User csb-1	Modèle:Utilisateur csb-1
Bee álnééhí:User cs-4	Modèle:Utilisateur cs-4
Bee álnééhí:User cr-1	Modèle:Utilisateur cr-1
Bee álnééhí:User bs-2	Modèle:Utilisateur bs-2
Bee álnééhí:User bg-4	Modèle:Utilisateur bg-4
Bee álnééhí:User bg-3	Modèle:Utilisateur bg-3
Bee álnééhí:User bg-2	Modèle:Utilisateur bg-2
Bee álnééhí:User be-3	Modèle:Utilisateur be-3
Bee álnééhí:User be-1	Modèle:Utilisateur be-1
Bee álnééhí:User an	Modèle:Utilisateur an
Bee álnééhí:User tt	Modèle:Utilisateur tt
Bee álnééhí:User gl-2	Modèle:Utilisateur gl-2
Bee álnééhí:User eu-3	Modèle:Utilisateur eu-3
Bee álnééhí:User ast	Modèle:Utilisateur ast
Bee álnééhí:User ro-3	Modèle:Utilisateur ro-3
Tʼááłáhági átʼéego:Dlǫ́ʼii yił Aheedaałtʼéhígíí	Catégorie:Herpestidae
Bee álnééhí:User nah-4	Modèle:Utilisateur nah-4
Bee álnééhí:User nah	Modèle:Utilisateur nah
Bee álnééhí:User mk-4	Modèle:Utilisateur mk-4
Bee álnééhí:User nds-4	Modèle:Utilisateur nds-4
Bee álnééhí:User or	Modèle:Utilisateur or
Tʼááłáhági átʼéego:Hoozdo Hahoodzodi kin naaznilígíí	Catégorie:Localité de l'Arizona
Bee álnééhí:User eu-2	Modèle:Utilisateur eu-2
Tʼááłáhági átʼéego:Hoozdo Hahoodzodi chidí naatʼaʼí ńdinibįįhígi	Catégorie:Aéroport de l'Arizona
Tʼááłáhági átʼéego:Yootó Hahoodzodi chidí naatʼaʼí ńdinibįįhígi	Catégorie:Aéroport du Nouveau-Mexique
Tʼááłáhági átʼéego:Beeʼeldííldahsinil	Catégorie:Albuquerque
Tʼááłáhági átʼéego:Chʼosh Deildeełii	Catégorie:Insectivore
Tʼááłáhági átʼéego:Choyoołʼįįhí sxu-4	Catégorie:Utilisateur sxu-4
Tʼááłáhági átʼéego:Tábąąstííntsoh	Catégorie:Pinnipède
Tʼááłáhági átʼéego:Táłkáaʼgi Tsídii	Catégorie:Anseriformes
Tʼááłáhági átʼéego:Tsísʼná dóó Wáláchííʼ	Catégorie:Apocrita
Tʼááłáhági átʼéego:Chʼosh bijáád tseebíhígíí	Catégorie:Arachnide
Tʼááłáhági átʼéego:Yágháhonikáánji biłnaaztʼiʼígíí	Catégorie:Exploration de l'espace
Tʼááłáhági átʼéego:Shash	Catégorie:Ursidae
Tʼááłáhági átʼéego:Tsin deiłkaałii	Catégorie:Picidae
Tʼááłáhági átʼéego:Tsékooh	Catégorie:Gorge
Tó bichʼoshtsoh	Belostomatidae
Tʼááłáhági átʼéego:Chʼosh bijáád neeznánígíí	Catégorie:Décapode
Tʼááłáhági átʼéego:Bílaʼashdlaʼii bilį́į́ʼ danilínígíí	Catégorie:Animal domestique
Tʼááłáhági átʼéego:Dziil / Atsiniltłʼish álʼį́	Catégorie:Énergie
Tʼááłáhági átʼéego:Shádiʼááh biyaadi dóó Kéyah Yistinígíí bikáaʼgi Ndaaldeehii	Catégorie:Faune en Antarctique
Tʼááłáhági átʼéego:Nahatʼeʼiitsoh Bikéyahdę́ę́ʼ Ndaaldeehii	Catégorie:Faune en Australie
Tʼááłáhági átʼéego:Tsʼíʼii dóó Tséʼédǫ́ʼii	Catégorie:Diptera
Bee álnééhí:User ko-4	Modèle:Utilisateur ko-4
Tʼááłáhági átʼéego:Tązhii dóó Naaʼahóóhai Ndahalinígíí	Catégorie:Galliformes
Tʼááłáhági átʼéego:Tééh łééchąąʼí	Catégorie:Hyaenidae
Tʼááłáhági átʼéego:Wónitłʼizí	Catégorie:Isopode
Tʼááłáhági átʼéego:Kǫʼ naʼałbąąsii ninádaaltłiʼígi	Catégorie:Gare
Tʼááłáhági átʼéego:Nahachagii dóó Nahakʼízii	Catégorie:Orthoptera
Tʼááłáhági átʼéego:Chéłchaaʼ bigaantéłígíí	Catégorie:Scarabaeidae
Tʼááłáhági átʼéego:Tábąąsdísí	Catégorie:Scolopacidae
Tʼááłáhági átʼéego:Séigoʼ	Catégorie:Scorpiones
Tʼááłáhági átʼéego:Táłtłʼááhdę́ę́ʼ dóó tónteel biyiʼdę́ę́ʼ chʼiyáán	Catégorie:Fruit de mer
Tʼááłáhági átʼéego:Tsin naaʼeeł	Catégorie:Bateau
Tʼááłáhági átʼéego:Áshįįh Biiʼtó Hahoodzodi kin naazniilígíí	Catégorie:Localité de l'Utah
Tʼááłáhági átʼéego:Naʼashjéʼii	Catégorie:Araignée
Tʼááłáhági átʼéego:Jááłánii	Catégorie:Myriapode
Tʼááłáhági átʼéego:Chʼosh doo yitʼíinii	Catégorie:Microorganisme
Tʼááłáhági átʼéego:Bisóodi	Catégorie:Race porcine
Tʼááłáhági átʼéego:Choyoołʼįįhí ba-3	Catégorie:Utilisateur ba-3
Tʼááłáhági átʼéego:Choyoołʼįįhí ba-4	Catégorie:Utilisateur ba-4
Tʼááłáhági átʼéego:Choyoołʼįįhí ba-N	Catégorie:Utilisateur ba-M
Tʼááłáhági átʼéego:Choyoołʼįįhí ce-1	Catégorie:Utilisateur ce-1
Tʼááłáhági átʼéego:Choyoołʼįįhí dsb-3	Catégorie:Utilisateur dsb-3
Tʼááłáhági átʼéego:Choyoołʼįįhí dsb-4	Catégorie:Utilisateur dsb-4
Tʼááłáhági átʼéego:Choyoołʼįįhí frr-N	Catégorie:Utilisateur frr-M
Tʼááłáhági átʼéego:Choyoołʼįįhí hsb-4	Catégorie:Utilisateur hsb-4
Tʼááłáhági átʼéego:Choyoołʼįįhí jv-4	Catégorie:Utilisateur jv-4
Tʼááłáhági átʼéego:Choyoołʼįįhí kg-1	Catégorie:Utilisateur kg-1
Tʼááłáhági átʼéego:Choyoołʼįįhí nn-4	Catégorie:Utilisateur nn-4
Tʼááłáhági átʼéego:Choyoołʼįįhí no-4	Catégorie:Utilisateur no-4
Tʼááłáhági átʼéego:Azeeʼ	Catégorie:Plante médicinale
Tʼááłáhági átʼéego:Choyoołʼįįhí vo-3	Catégorie:Utilisateur vo-3
Tʼááłáhági átʼéego:Choyoołʼįįhí vo-4	Catégorie:Utilisateur vo-4
Tʼááłáhági átʼéego:Choyoołʼįįhí nl-4	Catégorie:Utilisateur nl-4
Tʼááłáhági átʼéego:Naʼastsʼǫǫsí dóó Łéʼétsoh	Catégorie:Muridae
Bee álnééhí:User cs-2	Modèle:Utilisateur cs-2
Bee álnééhí:Image label begin	Modèle:Image label début
Tʼááłáhági átʼéego:Choyoołʼįįhí ay-2	Catégorie:Utilisateur ay-2
Tʼááłáhági átʼéego:Choyoołʼįįhí ay-3	Catégorie:Utilisateur ay-3
Tʼááłáhági átʼéego:Choyoołʼįįhí ay-N	Catégorie:Utilisateur ay-M
Tʼááłáhági átʼéego:Choyoołʼįįhí ce-4	Catégorie:Utilisateur ce-4
Tʼááłáhági átʼéego:Choyoołʼįįhí hsb-N	Catégorie:Utilisateur hsb-M
Tʼááłáhági átʼéego:Choyoołʼįįhí mn-4	Catégorie:Utilisateur mn-4
Tʼááłáhági átʼéego:Choyoołʼįįhí pdc-N	Catégorie:Utilisateur pdc-M
Tʼááłáhági átʼéego:Choyoołʼįįhí qu-4	Catégorie:Utilisateur qu-4
Tʼááłáhági átʼéego:Choyoołʼįįhí sxu-N	Catégorie:Utilisateur sxu-M
Tʼááłáhági átʼéego:Choyoołʼįįhí fa-4	Catégorie:Utilisateur fa-4
Tʼááłáhági átʼéego:Naakaii Łizhiní Bikéyahdi Hadahóólįįdígíí	Catégorie:Afrotheria
Tʼááłáhági átʼéego:Choyoołʼįįhí chr-3	Catégorie:Utilisateur chr-3
Tʼááłáhági átʼéego:Choyoołʼįįhí mg-1	Catégorie:Utilisateur mg-1
Bee álnééhí:User nn-3	Modèle:Utilisateur nn-3
Bee álnééhí:User vi	Modèle:Utilisateur vi
Tʼááłáhági átʼéego:Nahatʼeʼiitsoh Danilínígíí	Catégorie:Macropodiformes
Tʼááłáhági átʼéego:Choyoołʼįįhí en-1	Catégorie:Utilisateur en-1
Tʼááłáhági átʼéego:Choyoołʼįįhí de-1	Catégorie:Utilisateur de-1
Tʼááłáhági átʼéego:Choyoołʼįįhí chr-4	Catégorie:Utilisateur chr-4
Tʼááłáhági átʼéego:Choyoołʼįįhí hess	Catégorie:Utilisateur hess
Tʼááłáhági átʼéego:Choyoołʼįįhí hess-N	Catégorie:Utilisateur hess-M
Tʼááłáhági átʼéego:Choyoołʼįįhí da-N	Catégorie:Utilisateur da-M
Tʼááłáhági átʼéego:Choyoołʼįįhí vo-N	Catégorie:Utilisateur vo-M
Tʼááłáhági átʼéego:Choyoołʼįįhí gl-2	Catégorie:Utilisateur gl-2
Tʼááłáhági átʼéego:Choyoołʼįįhí or	Catégorie:Utilisateur or
Yaaʼ bijáád tseebíhígíí	Tique
Bee álnééhí:User ay-4	Modèle:Utilisateur ay-4
Hatinídę́ę́ʼ tsídiiłgaii	Chionididae
Dahsání	Porc-épic d'Amérique
Bee álnééhí:User nl-4	Modèle:Utilisateur nl-4
Bee álnééhí:User no-4	Modèle:Utilisateur no-4
Bee álnééhí:User nn-1	Modèle:Utilisateur nn-1
Bee álnééhí:User lt-2	Modèle:Utilisateur lt-2
Bee álnééhí:User ru-3	Modèle:Utilisateur ru-3
Bee álnééhí:User be-4	Modèle:Utilisateur be-4
Bee álnééhí:User az-1	Modèle:Utilisateur az-1
Bee álnééhí:User nl-3	Modèle:Utilisateur nl-3
Bee álnééhí:User nn	Modèle:Utilisateur nn
Bee álnééhí:User az-4	Modèle:Utilisateur az-4
Bee álnééhí:User hsb-4	Modèle:Utilisateur hsb-4
Bee álnééhí:User dsb-1	Modèle:Utilisateur dsb-1
Bee álnééhí:User bar	Modèle:Utilisateur bar
Bee álnééhí:User li	Modèle:Utilisateur li
Bee álnééhí:User bar-2	Modèle:Utilisateur bar-2
Bee álnééhí:User hy-2	Modèle:Utilisateur hy-2
Bee álnééhí:User fy	Modèle:Utilisateur fy
Bee álnééhí:User sv-4	Modèle:Utilisateur sv-4
Bee álnééhí:User dsb-3	Modèle:Utilisateur dsb-3
Bee álnééhí:User hi	Modèle:Utilisateur hi
Bee álnééhí:User hu-2	Modèle:Utilisateur hu-2
Bee álnééhí:User hr-4	Modèle:Utilisateur hr-4
Bee álnééhí:User sw-2	Modèle:Utilisateur sw-2
Bee álnééhí:User als-3	Modèle:Utilisateur als-3
Bee álnééhí:User bar-3	Modèle:Utilisateur bar-3
Bee álnééhí:User th-2	Modèle:Utilisateur th-2
Bee álnééhí:User sh-2	Modèle:Utilisateur sh-2
Bee álnééhí:User hu-4	Modèle:Utilisateur hu-4
Bee álnééhí:User cy-4	Modèle:Utilisateur cy-4
Bee álnééhí:User hu-3	Modèle:Utilisateur hu-3
Bee álnééhí:User bar-4	Modèle:Utilisateur bar-4
Bee álnééhí:User sw-4	Modèle:Utilisateur sw-4
Bee álnééhí:User tt-4	Modèle:Utilisateur tt-4
Bee álnééhí:User ga-3	Modèle:Utilisateur ga-3
Bee álnééhí:User qu	Modèle:Utilisateur qu
Bee álnééhí:User dsb-4	Modèle:Utilisateur dsb-4
Bee álnééhí:User kn-1	Modèle:Utilisateur kn-1
Bee álnééhí:User sl-4	Modèle:Utilisateur sl-4
Bee álnééhí:User vi-3	Modèle:Utilisateur vi-3
Bee álnééhí:User th-3	Modèle:Utilisateur th-3
Bee álnééhí:User ta-2	Modèle:Utilisateur ta-2
Bee álnééhí:User hy-3	Modèle:Utilisateur hy-3
Bee álnééhí:User id-1	Modèle:Utilisateur id-1
Kʼaalógii	Rhopalocères
Akétłʼóól łichxííʼí yázhí	Radis
Bee álnééhí:Nobots	Modèle:Nobots
Tsé nahalinii (łóóʼ)	Synanceia
Tʼááłáhági átʼéego:Choyoołʼįįhí als-4	Catégorie:Utilisateur als-4
Bee álnééhí:User gsw	Modèle:Utilisateur gsw
Wónitłʼizí ntsxaaígíí	Bathynomus
Special:RecentChanges	Spécial:Modifications récentes
Tʼááłáhági átʼéego:Choyoołʼįįhí ja-4	Catégorie:Utilisateur ja-4
Ábishjaaʼ łóóʼ	Dendrogramma
