افريقا	Afrique
جاپان	Japon
سوېلي امريکا	Amérique du Sud
ناروې	Norvège
د آيرلېنډ جمهوريت	Irlande (pays)
هنگري	Hongrie
اسپانیا	Espagne
د امریکا متحده ایالتونه	États-Unis
بلجیم	Belgique
لوگزامبورگ	Luxembourg (pays)
ځمکه	Terre
ژوند	Vie
انسان	Homo sapiens
فېنلانډ	Finlande
سويډن	Suède
ډېنمارک	Danemark
پولنډ	Pologne
لېتوانيا	Lituanie
اېټاليا	Italie
سويس	Suisse
اتريش	Autriche
يونان	Grèce
تورکيه	Turquie
بير	Bière
پرتگال	Portugal
اروپا	Europe
آسيا	Asie
شمالي امريکا	Amérique du Nord
انټارکټيکا	Antarctique
ويکيپېډيا	Wikipédia
هالنډ	Pays-Bas
نيويارک (ښار)	New York
واشنگټن ډي سي	Washington (district de Columbia)
برلين	Berlin
سولگر	Ordinateur
څوریخ	Zurich
انټرنټ	Internet
باراک حسين اوباما	Barack Obama
لندن	Londres
قاهره	Le Caire
مڼه	Pomme
پاريس	Paris
گووگل	Google
اتلانتيک سمندر	Océan Atlantique
غلی سمندر	Océan Pacifique
کالېفورنیا	Californie
دونۍ	Lundi
جنوري	Janvier
فبروري	Février
مارچ	Mars (mois)
مريخ	Mars (planète)
کېنيا	Kenya
اېتوپیا	Éthiopie
گانا	Ghana
اپرېل	Avril
مې	Mai
جون	Juin
جولای	Juillet
اگسټ	Août
سپټمبر	Septembre
اکتوبر	Octobre
نومبر	Novembre
ډيسمبر	Décembre
درې نۍ	Mardi
شورو	Mercredi
زيارت	Jeudi
جمعه	Vendredi
خالي	Samedi
يونۍ	Dimanche
زمری	Lion
فرانسه	France
سپی	Chien
بريتانيا	Royaume-Uni
پيشو	Chat
چين د خلکو جمهوريت	Chine
فرانسوي ژبه	Français
اېتنول	Éthanol
برازیل	Brésil
روسیه	Russie
نهنگ	Cetacea
څلوريځ (مېچپوهنه)	Carré
بوینگ ۷۴۷	Boeing 747
ويکيمېډيا بنسټ	Wikimedia Foundation
آلمان	Allemagne
بېلاروس	Biélorussie
آلماني ژبه	Allemand
آيسلېنډ	Islande
الله	Dieu
اېسټونيا	Estonie
زحل	Saturne (planète)
الوتکه	Avion
جگړه	Guerre
جورج واکر بوش	George W. Bush
اوکراین	Ukraine
چېک جمهوريت	République tchèque
سلواکيا	Slovaquie
سلووانیا	Slovénie
مولدوا	Moldavie
رومانیا	Roumanie
بلغاریا	Bulgarie
د مقدونيې ولسمشريزه	Macédoine (pays)
البانیا	Albanie
کروواسيا	Croatie
آزربايجان	Azerbaïdjan
اندورا	Andorre
گرجستان	Géorgie (pays)
قزاقستان	Kazakhstan
مالټا	Malte
مانتېنېگرو	Monténégro
واټيکان ښار	Vatican
سان مارینو	Saint-Marin
بروکسل	Région de Bruxelles-Capitale
بېلیز	Belize
باربادوس	Barbade
اندونيزيا	Indonésie
ولفگانگ امادیوس موزارت	Wolfgang Amadeus Mozart
لیودویگ وان بیتهووین	Ludwig van Beethoven
تورکي ژبه	Turc
سویلي افریقا	Afrique du Sud
الجزاير	Algérie
اوزبکستان	Ouzbékistan
تاشکند	Tachkent
اوبه	Eau
تلويزون	Télévision
چېلي	Chili
عيسی	Jésus-Christ
گاليليو گاليلی	Galilée (savant)
عطارد	Mercure (planète)
پېښليک	Histoire
ژبه	Langage
زورواکي	Dictature
مشتري	Jupiter (planète)
میشل باشله	Michelle Bachelet
ستورپوهنه	Astronomie
سينگاپور	Singapour
پوهنه	Science
تکړښت	Sport
اډولف هټلر	Adolf Hitler
فېس بوک	Facebook
ويکيلېکس	WikiLeaks
لومړنۍ نړېواله جگړه	Première Guerre mondiale
دويمه نړېواله جگړه	Seconde Guerre mondiale
گړيال	Horloge
شچېچېن	Szczecin
شمېرپوهنه	Mathématiques
لاتين ژبه	Latin
بحرین	Bahreïn
ارمنستان	Arménie
مېخي ليکدود	Cunéiforme
هیگزبوسون	Boson de Higgs
سربيا	Serbie
سپوږمۍ	Lune
استنبول	Istanbul
آسټراليا	Australie
پنځپوهنه	Physique
ارجنټاین	Argentine
مخابرات	Télécommunications
پيرو	Pérou
ژونپوهنه	Biologie
شمالي کوريا	Corée du Nord
کمبودیا	Cambodge
قرآن	Coran
ډانگسر	Dinosaure
ژوپوهنه	Zoologie
اسلام	Islam
ناک	Pyrus
بوټپوهنه	Botanique
لېخ والېسا	Lech Wałęsa
اروپايي اتحاديه	Union européenne
WWW	World Wide Web
شعر	Poésie
کمپيوټري ويروس	Virus informatique
ليمو	Citron
گل	Fleur
ناپليون بوناپارت	Napoléon Ier
لمر	Soleil
آسمان	Ciel
وېکټور هوگو	Victor Hugo
اقيانوسيه	Océanie
لمريز غونډال	Système solaire
هايډروجن	Hydrogène
انگېلا مېرکل	Angela Merkel
لوړغږی	Haut-parleur
ورځ	Jour
شپه	Nuit
کال	Année (calendrier)
پېړۍ	Siècle
اوسلو	Oslo
جنسي اړيکې	Comportement sexuel humain
دوبۍ	Dubaï (émirat)
آکسيجن	Oxygène
سياره	Planète
سندارا	Musique
مسکو	Moscou
چاډ	Tchad
الومېنيم	Aluminium
هند	Inde
اوسپنه	Fer
لوېديځ	Ouest
گوگړ	Soufre
ساموا	Samoa
ختيځ	Est
وېليم شېکسپيير	William Shakespeare
نكل	Fable
مارشال ټاپووان	Îles Marshall
مغولستان	Mongolie
سترنج	Échecs
چنگېز خان	Gengis Khan
آس	Cheval
امسټرډام	Amsterdam
وسله	Arme
ژوي	Animal
سورينام	Suriname
گويانا	Guyana
اېکوادور	Équateur (pays)
ځمکني توتان	Fragaria
بوديزم	Bouddhisme
بولېویا	Bolivie
تامبه	Cuivre
بوټی	Plante
سېنټ لوسیا	Sainte-Lucie
ليونارډو ډاوېنچي	Léonard de Vinci
چڼاس	Fungi
جمايکا	Jamaïque
گرېنادا	Grenade (pays)
گواتمالا	Guatemala
هندوراس	Honduras
ډومنيکان جمهوريت	République dominicaine
اهلي خوگ	Porc
شمالي قطبي سمندر	Océan Arctique
هایتي	Haïti
اېلسلوادور	Salvador
ايران	Iran
عراق	Irak
کوسټاریکا	Costa Rica
اسرائيل	Israël
پاناما	Panama
يمن	Yémen
اردن	Jordanie
نیکاراگوا	Nicaragua
قرغزستان	Kirghizistan
کوېټ	Koweït
لاووس	Laos
لېبنان	Liban
مالديپ	Maldives
امريکا لويه وچه	Amérique
ميانمار	Birmanie
نيپال	Népal
عمان	Oman
پاکستان	Pakistan
قطر	Qatar
سعودي عربستان	Arabie saoudite
سریلانکا	Sri Lanka
جوزف سټالين	Joseph Staline
سوريه	Syrie
اپلاتون	Platon
تاجيکستان	Tadjikistan
د چين جمهوريت	Taïwan
يوټيوب	YouTube
ارستو	Aristote
تايلنډ	Thaïlande
اورگاډی	Train
آرسېنيک	Arsenic
راډيو	Radiodiffusion
تورکمنستان	Turkménistan
عربي متحده امارات	Émirats arabes unis
چارلس چاپلين	Charlie Chaplin
سوېلي کوريا	Corée du Sud
سمپسنز	Les Simpson
افغانستان	Afghanistan
بنگله دېش	Bangladesh
فرانتس کافکا	Franz Kafka
مالي	Mali
سوقرات	Socrate
آنگولا	Angola
بوتان	Bhoutan
ټويټر	Twitter
برونای	Brunei
تانزانیه	Tanzanie
پاره	Mercure (chimie)
فلېپين	Philippines
د منځنی افريقا ولسمشريزه	République centrafricaine
آيزاک نيوټن	Isaac Newton
آلبرټ آينشټاين	Albert Einstein
تونس	Tunisie
زېمبيا	Zambie
زېمبابوې	Zimbabwe
بېجنگ	Pékin
سوېلي سوډان	Soudan du Sud
بېنين	Bénin
بوتسوانا	Botswana
بورکینا فاسو	Burkina Faso
بروندي	Burundi
کانگو جمهوريت	République du Congo
جېبوتي	Djibouti
پولونيم	Polonium
باډن ورټمبرگ	Bade-Wurtemberg
اریتره	Érythrée
فيودور ميخايلوويچ داستاېفسکي	Fiodor Dostoïevski
گابن	Gabon
مهاتما گاندي	Mohandas Karamchand Gandhi
گامبيا	Gambie
عاج ساحل	Côte d'Ivoire
کامرون	Cameroun
لايبېريا	Liberia
لېبيا	Libye
مادغاسکر	Madagascar
مالاوي	Malawi
موریتانيا	Mauritanie
ماوریتوس	Maurice (pays)
مراکش	Maroc
موزمبيق	Mozambique
نېمبیا	Namibie
نایجېر	Niger
نايجېريا	Nigeria
راونډا	Rwanda
سېنېگال	Sénégal
سیشل	Seychelles
سېرالیون	Sierra Leone
سومالیا	Somalie
سوډان	Soudan
سوازيلانډ	Swaziland
شنه زرغونه	Arc-en-ciel
استقلاب	Métabolisme
ملگري ملتونه	Organisation des Nations unies
دانتې الیگيري	Dante Alighieri
ځمکپېژندنه	Géologie
ځمکپوهنه	Géographie
زړه	Cœur
ماغزه	Cerveau
پراگ	Prague
شين	Bleu
سپين زر	Argent
يورانيم	Uranium
پلوتونيم	Plutonium
ممبای	Bombay
گوا	Goa
مهاراشترا	Maharashtra
زارلاند	Sarre (Land)
براندنبورگ	Brandebourg
برېمن (ايالت)	Brême (Land)
بيت المقدس	Jérusalem
هندي سمندر	Océan Indien
کلراډو	Colorado
ژمی	Hiver
پسرلی	Printemps
دوبی	Été
منی	Automne
اسامه بن لادن	Oussama ben Laden
اوپرا	Opéra
کلکته	Calcutta
ډېلي	Delhi
بند پایان	Arthropode
اسلام آباد	Islamabad
پيسې	Monnaie
خوځندکې	Insecte
ولادمير ايليچ لېنين	Vladimir Ilitch Lénine
نېكولو مكياوېلې	Nicolas Machiavel
مايکروسافټ وېنډوز	Microsoft Windows
مانيلا	Manille
توکيو	Tokyo
استانه	Astana
بغداد	Bagdad
هندي ژبه	Hindi
اوردو ژبه	Ourdou
واليبال	Volley-ball
وين	Vienne (Autriche)
ډبلن	Dublin
بوډاپسټ	Budapest
د مسيح حقيقي کليسا	Véritable Jésus Église
انگرېزي ژبه	Anglais
بانگکوک	Bangkok
کوالالامپور	Kuala Lumpur
ديپلوماسي	Diplomatie
کيېف	Kiev
كونسكوولا	Końskowola
2012	2012
2013	2013
خواړه	Nourriture
اېلېکټرون	Électron
رغاويز اوښتون	Révolution industrielle
د روم ټولواکمني	Empire romain
مايکروسافټ	Microsoft
پروټون	Proton
کوروف	Kurów
کيميا	Chimie
نيوټرون	Neutron
صنعا	Sanaa
آرنولد شوارزنېگر	Arnold Schwarzenegger
فوټبال	Football
آيفون	IPhone
مايکل جېکسن	Michael Jackson
انتوان دي سينت اکسيوپيري	Antoine de Saint-Exupéry
سور	Rouge
هوا	Atmosphère terrestre
پېرى	Djinn
ربات	Rabat
الجزيره	Alger
ترابلس	Tripoli (Libye)
تهران	Téhéran
جکارتا	Jakarta
انقره	Ankara
رياض	Riyad
فوټ	Pied (unité)
وېشنيزه:د ويکيپېډيا کينډۍ	Catégorie:Espace Modèle
د مشق	Damas
لوم	Lomé
دوها	Doha
دودوما	Dodoma
ښوونځی	École
پوهنتون	Université
د پوهنغونډ په اړه	Aide:Premiers pas
آسټراليا (لويه وچه)	Continent australien
ورونپاسی	Ordinateur portable
الجبر	Algèbre
دونگ هوی هوايي ډگر	Aéroport de Đồng Hới
آر دړه	Carte mère
كوريتيبا	Curitiba
پنجاب (پاکستان)	Pendjab (Pakistan)
وېشنيزه:د افغانستان پېښليک	Catégorie:Histoire de l'Afghanistan
توماس شېن کانېري	Sean Connery
كنفيوشيوس	Confucius
کوربن بليو	Corbin Bleu
وېشنيزه:شمېرپوهنه	Catégorie:Mathématiques
وېشنيزه:د ایران تاریخ	Catégorie:Histoire de l'Iran
امريکايي ډالر	Dollar américain
عيسويت	Christianisme
لويه وچه	Continent
مرغه	Oiseau
پلازمېنه	Capitale
مياشت (موده)	Mois
مصطفی کمال اتاتورک	Mustafa Kemal Atatürk
کينډۍ:تانبه	Modèle:Portail
هوانگ شيان فان	Huang Xianfan
د فلسفې ليکلړ	Glossaire de philosophie
بقراط	Hippocrate
الماس	Diamant
پوهنغونډ	Encyclopédie
RAM	Mémoire vive
لومړی مخ	Wikipédia:Accueil principal
کانډنسر	Condensateur (électricité)
باسکټبال	Basket-ball
کرېکټ	Cricket
اوراسيا	Eurasie
د هېتیانو واکمنۍ	Hittites
وينه لږی	Anémie
کېپ ټاون	Le Cap
قراقرم	Karakoram
هندوکش	Hindou Kouch
ميترو	Métro
کنځری	Cotonéaster
پيکاسو	Pablo Picasso
بس	Autobus
ټرام	Tramway
بابل	Babylone
آنتون پاولوف چيخوف	Anton Tchekhov
چارلېز ډيکېنز	Charles Dickens
سپارتا	Sparte
موينجو دېړو	Mohenjo-daro
سمرقند	Samarcande
بخارا	Boukhara
چې گوارا	Che Guevara
کابل	Kaboul
گوېټه	Johann Wolfgang von Goethe
مهبل	Vagin
فلسفه	Philosophie
د مقدس ویټوس کليسا	Cathédrale Saint-Guy de Prague
چای	Thé
کمونيزم	Communisme
انارشيزم	Anarchisme
پانگولي	Capitalisme
لېبراليزم	Libéralisme
فاشېزم	Fascisme
ولسپالنه	Nationalisme
حافظ شېرازي	Hafez (poète)
هېوادپالنه	Patriotisme
هیواد	Pays
ولس	Nation
هيلري کلنټن	Hillary Clinton
د برتانيې موزيم	British Museum
ژان ژاک روسو	Jean-Jacques Rousseau
هومر	Homère
الكساندر هومبولدت	Alexander von Humboldt
کوارک	Quark
اېډوارډ ټېللر	Edward Teller
تور زېړی	Hépatite B
اتيزم	Athéisme
نيلز بوهر	Niels Bohr
ژونکيميا	Biochimie
ژونپنځپوهنه	Biophysique
چاپېريالپوهنه	Écologie
بارسلونا فوټبال کلب	FC Barcelone (football)
واگ	Politique
ووبپوهنه	Histologie
عربي ټولنه	Ligue arabe
ولسواکي	Démocratie
نجيب محفوظ	Naguib Mahfouz
د سره صليب او سرې مياشتې نړيوال غورځنگ	Mouvement international de la Croix-Rouge et du Croissant-Rouge
نړيوالتوب	Mondialisation
ناټو	Organisation du traité de l'Atlantique Nord
جين	Gène
حکومت	Gouvernement
نوبل جايزه	Prix Nobel
چېن شي هوانگ	Qin Shi Huang
منځنی ختيځ	Moyen-Orient
رنځپوهنه	Pathologie
رابندرانات ټاگور	Rabindranath Tagore
لېو نيكولايوويچ تولستوى	Léon Tolstoï
مارک ټوېن	Mark Twain
ايډيالوژي	Idéologie
ادا لولېس	Ada Lovelace
مارکسيزم	Marxisme
ولسمشريزه	République
دولت	État
گوند	Parti politique
بډمنټن	Badminton
يوري الکسويچ گاگارين	Youri Gagarine
ابن بطوطه	Ibn Battûta
اباسين (سيند)	Indus
فرانز جوزیف هایدن	Joseph Haydn
غوږ	Oreille
سترگه	Œil
سندره	Chanson
اوښ	Camelus
تی لرونکی ځناوران	Mammifère
مېږی	Fourmi
مارگريت تاچر	Margaret Thatcher
ډي آکسي رايبونيوکليک اسيد	Acide désoxyribonucléique
ژباړه	Traduction
ښامار	Dragon (mythologie)
مور	Mère
پلار	Père
لېږدچارې	Transport
روسي ژبه	Russe
ولادمير پوتين	Vladimir Poutine
حقوق	Droit
اساسي قانون	Constitution
د بشري حقونو نړېواله اعلاميه	Déclaration universelle des droits de l'homme
د روغتيا نړيوال سازمان	Organisation mondiale de la santé
د سوداگرۍ نړيوال سازمان	Organisation mondiale du commerce
پرېولنځی	Toilettes
طبيعت	Nature
سادرملنه	Psychiatrie
ژونکه	Cellule (biologie)
وينه	Sang
هډوانه	Squelette
سږي	Poumon
ساييز غونډال	Appareil respiratoire
رومانيايي ژبه	Roumain
بلغاريايي ژبه	Bulgare
ښوونپوهنه	Didactique
روزنپوهنه	Pédagogie
يمال	Avalanche
رېږدله	Séisme
طبيعي پوهنې	Science de la nature
ابن سينا بلخي	Avicenne
وېنسټون چرچل	Winston Churchill
نېلسن مانډېلا	Nelson Mandela
انزايم	Enzyme
امينو اسيد	Acide aminé
ورېځ	Nuage
سولپوهنه	Logique
مېچپوهنه	Géométrie
وټپوهنه	Sciences économiques
پانگه (وټپوهنه)	Capital
ارز	Devise (monnaie)
رغاوه	Industrie
ورکړېنه	Impôt
ژبپوهنه	Linguistique
يوناني ابېڅې	Alphabet grec
ادبپوهنه	Littérature
وېشنيزه:فرانسه	Catégorie:France
ناول	Roman (littérature)
سره گيدړه	Renard roux
اوستراوا	Ostrava
کوروش ۲	Cyrus le Grand
ټولنه	Société (sciences sociales)
تمدن	Civilisation
زده کړه	Éducation
هوگو چاوېز	Hugo Chávez
واده	Mariage
وگړنيز حقوق	Droits de l'homme
توکمپالنه	Racisme
گوډ تېمور	Tamerlan
عمر بن خطاب	Omar ibn al-Khattâb
پوځ	Armée
سلیمان ۱	Soliman le Magnifique
قهوه	Café
د آمو سيند	Amou-Daria
شيدې	Lait
ارغنداب رود	Arghandab (rivière)
غر	Montagne
هري رود	Hari Rûd
هلمند رود	Helmand (rivière)
توكبنسټ	Base de données
کابل سيند	Kaboul (rivière)
د افغانستان ملي پوليس	Police nationale afghane
صلاح الدين ايوبي	Saladin
اشوک	Ashoka
جلال الدين محمد اکبر	Akbar
هانگ کانگ	Hong Kong
کراچۍ	Karachi
د ريال مادريد فوټبال کلب	Real Madrid Club de Fútbol
سيول	Séoul
شانگهای	Shanghai
د ماد واکمني	Mèdes
اقليدس	Euclide
بايټ	Byte
محمد بن موسی خوارزمي	Al-Khwârizmî
ناروېژي ژبه	Norvégien
نوم چومسكي	Noam Chomsky
چيکی ژبه	Tchèque
کارل مارکس	Karl Marx
موسی	Moïse
پوهه	Connaissance
هندويزم	Hindouisme
اټوم	Atome
يوناني ژبه	Grec
چليز غونډال	Système d'exploitation
تاج محل	Taj Mahal
بنسټپالنه	Fondamentalisme
برېښليک	Courrier électronique
پاړسي ژبه	Persan
مذهب	Religion
اېمپاير سټېټ ودانۍ	Empire State Building
سېگمونډ فرايډ	Sigmund Freud
جاينيزم	Jaïnisme
گيورگ ويلهېلم فرېدرېش هېگل	Georg Wilhelm Friedrich Hegel
باکو	Bakou
تاجکي ژبه	Tadjik
اوزبکي ژبه	Ouzbek
تورکمني ژبه	Turkmène
يهوديت	Judaïsme
آزربايجاني ژبه	Azéri
ابن خلدون	Ibn Khaldoun
امانوېل کانت	Emmanuel Kant
سکيزم	Sikhisme
فرېدرېک وېلهېلم نېتشي	Friedrich Nietzsche
بشکیک	Bichkek
دوشنبه	Douchanbé
اينه	Foie
پښتورگی	Rein
ادم سمېت	Adam Smith
احساس	Émotion
ساپوهنه	Psychologie
آند	Pensée
مهاوېرا	Mahāvīra
سمندر	Océan
ملکه وېکټوريا	Victoria (reine)
محمد	Mahomet
اخلاق	Éthique
پوهنپوهنه	Épistémologie
سچين رمېش ټنډولکر	Sachin Tendulkar
عبدالکلام	Avul Pakir Jainulabdeen Abdul Kalam
بي بي سي	British Broadcasting Corporation
شاهرخ خان	Shahrukh Khan
سلمان خان	Salman Khan
محمد الغزالي	Al-Ghazâlî
عامر خان	Aamir Khan
اميتاببچن	Amitabh Bachchan
شيعه	Chiisme
گېډه	Abdomen
زرتشتيت	Zoroastrisme
تصوف	Soufisme
ژبه (اناتومي)	Langue (anatomie humaine)
پانکراس	Pancréas
غاړه	Cou
کمزوره شوي یورانیم	Uranium appauvri
هولي	Holi
زړه پوهنه	Cardiologie
ډېوېډ بکهم	David Beckham
کيم جونگ ايل	Kim Jong-il
وېشنيزه:وېنزوېلا	Catégorie:Venezuela
روبېرت موگابي	Robert Mugabe
خاپوړن	Reptile
کوتره	Columbidae
باکټريا	Bacteria
ونه	Arbre
دوه ژوندوي	Amphibia
اوښتون	Révolution (politique et sociale)
انگور	Raisin
گبين	Miel
کچالو	Pomme de terre
سابه	Légume
ټکنالوجي	Technologie
انجينري	Ingénierie
خبريالي	Journalisme
ورځپاڼه	Journal
غږلېږدی	Téléphone
هڅوب	Culture
سانسکریت ژبه	Sanskrit
د زړه او رگونو غونډال	Appareil cardiovasculaire
د پارکېنسون ناروغي	Maladie de Parkinson
گارډيان	The Guardian
انډيپېنډنټ	The Independent
درملگري	Médecine
مقننه قوه	Pouvoir législatif
مالگه	Sel alimentaire
مايکروسافټ آفېس	Microsoft Office
وېشنيزه:رومانیا	Catégorie:Roumanie
کيمياوي توکی	Élément chimique
ابن باجه	Avempace
هورمون	Hormone
اپارتايد	Apartheid
لوبه	Jeu
جودو	Judo
مقناطيس	Aimant permanent
ساهيالي	Image animée
کرنه	Agriculture
غږ	Son (physique)
نانو تکنالوژي	Nanotechnologie
ښيښه	Verre
وخت	Temps
ليکپاڼه	Papier
کازمېکي وړانگې	Rayon cosmique
جوار	Maïs
انځورکښنه	Peinture
تشیالیونی	Astronaute
انځوراخيستنه	Photographie
برېښنايي ټېکنالوژي	Électronique
فريکونسي	Fréquence
خوړنځی	Restaurant
د لودیانو ټولواکمني	Dynastie des Lodi
لاهور	Lahore
د خپلواکو هېوادونو لړليک	Liste des pays du monde
ابوريحان بيروني	Al-Biruni
څېړۍ	Chêne
سرطان	Cancer
کولرا	Choléra
غنم	Blé
ناروغي	Maladie
گرېگوري کليز	Calendrier grégorien
نیکوتین	Nicotine
روغتيا	Santé
ملاريا	Paludisme
انټيبايوټيک	Antibiotique
پنسلين	Pénicilline
نېمونيا	Pneumonie aiguë
گوزڼ	Poliomyélite
اېډز	Syndrome d'immunodéficience acquise
نری رنځ	Tuberculose
ډايبېټېز مېلېټوز	Diabète sucré
صليبي جگړې	Croisades
منځنۍ پېړۍ	Moyen Âge
عثماني پېر	Empire ottoman
د کورنيو توليداتو ټوليز ارزښت	Produit intérieur brut
برېښنا	Électricité
یان آموس کمېنسکي	Comenius
اټومي برېښناکوټ	Énergie nucléaire
د بړاس ماشين	Machine à vapeur
توره (وسله)	Épée
هستوي وسلې	Arme nucléaire
شوبله	Char de combat
هرمان ون رومپوې	Herman Van Rompuy
غرني توت	Bleuet (fruit)
تورتوت	Mûre (fruit de la ronce)
ناريال	Cocos nucifera
انار	Grenade (fruit)
مالټه	Orange (fruit)
A New Etymological Vocabulary of Pashto	Kiwi
گراڅ	Graz
ډېبټ کارډ	Carte de paiement
انجلينا جولي	Angelina Jolie
عربي ژبه	Arabe
کانډوم	Préservatif
تيرانوسور	Tyrannosaurus
تریسراتوپس	Triceratops
ستگوسور	Stegosaurus
کارکارودونتوسور	Carcharodontosaurus
وچکښ	Crayon
برنو	Brno
هوجينتاو	Hu Jintao
د شوروي سوسياليستي جمهوريتونو اتحاد	Union des républiques socialistes soviétiques
انځورۍ	Appareil photographique
اېچ آی وي	Virus de l'immunodéficience humaine
يومکی	Omoplate
ځاني سولگر	Ordinateur personnel
بروس لي	Bruce Lee
هايپوتايرايډيزم	Hypothyroïdie
نړۍ	Monde (univers)
د روم جمهوريت	République romaine
ټریلوبیټ	Trilobita
گردکه	Cercle
گرځنده غږلېږدی	Téléphone mobile
اوښمرغه	Autruche d'Afrique
ويټامين اې	Vitamine A
بغ	Ardeidae
پيونگيانگ	Pyongyang
د لور موندنې نړيوال غونډال	Global Positioning System
د هېوادونو لړليک د کورنيو توليداتو د ټوليز ارزښت له مخې	Liste des pays par PIB nominal
جگتورن	Capitaine
سمندري غڼې	Pycnogonida
لړم	Scorpiones
ما اينگ جيو	Ma Ying-jeou
سمندري لړمان	Eurypterida
بخارست	Bucarest
لوور	Musée du Louvre
تیرانا	Tirana
ويکټوريا بېکهم	Victoria Beckham
درېڅنډی	Triangle
سټيف جوبز	Steve Jobs
معمر القذافي	Mouammar Kadhafi
پړانگ	Tigre
لومړی خوان کارلوس	Juan Carlos Ier
مېچې	Vermicelle
لمسنالۍ	Pavé tactile
سامسونگ	Groupe Samsung
سولگرپوهنه	Informatique
ټولنپوهنه	Sociologie
گاگره	Béton
جغرافي کوراډينېټونو سيستم	Coordonnées géographiques
پڼې	Chaussure
بهايي	Bahaïsme
بانک	Banque
د وينا ازادي	Liberté d'expression
اډېل	Adele
د نش ميزان	Équilibre de Nash
هوږه	Ail cultivé
وگړپوهنه	Anthropologie
بادرنگ	Concombre
ارنېست مېلر هېمېنگوې	Ernest Hemingway
عشق آباد	Achgabat
ټاپو	Île
تور (رنگ)	Noir
پياز	Oignon
رسمي ژبه	Langue officielle
لرغونپوهنه	Archéologie
بالکان	Balkans
سلاوي ژبې	Langues slaves
سر	Tête (anatomie)
ولسي لاره	Hymne national
تماسي عدسيه	Lentilles de contact
الفرېډ نوبل	Alfred Nobel
ږمنځ	Peigne
لیلا داونز	Lila Downs
موسم	Saison
راولپنډۍ ولسوالۍ	District de Rawalpindi
ډبرين سکاره	Charbon
يارمخچۍ	Alouette calandrelle
نينورشک	Nynorsk
بوکمول	Bokmål
کونگ	Strigiformes
شمزۍ لرونکي ژوي	Vertébrés
نړېوال تشيال تمځای	Station spatiale internationale
ISO 3166-1	ISO 3166-1
کجوره	Phoenix dactylifera
څټک	Marteau (outil)
اروپايي کاغۍ	Pie bavarde
چابکۍ	Blattaria
كوچنى شاهزاده	Le Petit Prince
شمالي باز	Autour des palombes
غضروفی کبان	Chondrichthyes
ځنگلي سار	Buse variable
سيلاني کارغه	Corbeau freux
لويديځي کاغۍ	Choucas des tours
شودپۍ	Bergeronnette grise
اېشېريکيا کولي	Escherichia coli
توتکۍ	Hirondelle rustique
گنگو	Safran (épice)
ترکاڼک	Picidae
شامتوره	Étourneau sansonnet
کوشانيان	Empire kouchan
کومکۍ	Pigeon ramier
جوک	Linotte mélodieuse
آتروپين	Atropine
شين شارک	Requin bleu
اورني سمندر	Salamandra salamandra
سپوږمکۍ	Satellite artificiel
شينغاړی	Gorgebleue à miroir
تورياڼۍ	Apodidae
لونگ	Giroflier
زيره	Carvi
وژونکی نهنگ	Orque
سپېرکونده	Cochevis huppé
منځنۍ آسيا	Asie centrale
شمالي افريقا	Afrique du Nord
مرکزي افريقا	Afrique centrale
ختيځه اروپا	Europe de l'Est
لوېديځه اروپا	Europe de l'Ouest
افريقايي اوراسيا	Afro-Eurasie
د فلسفې تاريخ	Histoire de la philosophie
زي نړیواله جگړه (فلم)	World War Z (film)
مړز	Caille des blés
مروری	Matricaria recutita
چې زېټ ۸۰۵ برېن توپک	CZ-805 BREN
کمول (مارغه)	Cigogne
اوبدانه	Textile
توکي	Bien (économie)
سپوږميز ليږديز کليز	Calendrier musulman
ميلوش زېمان	Miloš Zeman
اېف-۱۵	McDonnell Douglas F-15 Eagle
ليوکېمي	Leucémie
پارسیمن	Kaki
ديموکراتيک گوند ( د امريکا متحده ایالتونه)	Parti démocrate (États-Unis)
ټيکاله	Alaudidae
شاتو مچی	Apis mellifera
خاورين چينجی	Lumbricus terrestris
ولسمشر	Président
باشه	Faucon pèlerin
رودولف کلاوزيوس	Rudolf Clausius
تورغوږی	Caracal
ډېل	Dell
زايلومېټازولين	Xylométazoline
شمېرنی	Calculatrice
ايډمونډ شارپ	Edmund Sharpe
شاه محمود هوتک	Mahmoud (Ghilzai)
امير عبدالرحمان خان	Abdur Rahman Khan
ټکټکی	Jynx (genre)
د عربستان ټاپووزمه	Arabie
امير دوست محمد خان	Dost Mohammad Khan
بېریف بې-۲۰۰	Beriev Be-200
پهلوي ژبه	Pehlevi
وری	Bélier (astrologie)
جېهلم ولسوالۍ	District de Jhelum
ملاله يوسفزۍ	Malala Yousafzai
جومات	Mosquée
بلوڅی ژبه	Baloutche
د کتاب نړيواله کره شمېره	International Standard Book Number
د کندهار نړيوال هوايي ډگر	Aéroport international de Kandahar
د مغولو پاچايي	Empire moghol
گړدود	Dialecte
ایرانی ژبی	Langues iraniennes
هېما مالېني	Hema Malini
لاس	Main
خلکو شمېر	Population
د پاکستان ژبې	Langues au Pakistan
پاڼه	Feuille
لوبگر	Acteur
هاليووډ	Hollywood
محمد حسنی مبارک	Hosni Moubarak
دينپوهنه	Théologie
پابلو نرودا	Pablo Neruda
زیوس	Zeus
موساد	Mossad
یغنابی ژبه	Yaghnobi
انجيل	Évangiles
الېکسانډر گراهام بېل	Alexander Graham Bell
ستورپېژندنه	Astrologie
ساز	Instrument de musique
ويټني هيوسټن	Whitney Houston
سابون	Savon
موشوفتسی	Mošovce
شکيرا	Shakira
محمود احمدي نژاد	Mahmoud Ahmadinejad
كېښكلى ټيكلى (CD)	Disque compact
چورلکه	Hélicoptère
القاعده	Al-Qaïda
محمد فاتح	Mehmed II
اناستاسيا	Anastacia
فرات	Euphrate
البېرټ کامو	Albert Camus
د فارس خليج	Golfe Persique
قطب نما	Boussole
ټولنيزې پوهنې	Sciences humaines et sociales
ټاپووزمه	Péninsule
نوی کال	Jour de l'an
اېف-۱۴	Grumman F-14 Tomcat
ويټامين	Vitamine
تورات	Torah
كرم	Chou cabus
متل	Proverbe
هينداره	Miroir
لرغونې پاړسي	Vieux-perse
عربان	Arabes
براډ پېت	Brad Pitt
کړکۍ	Fenêtre
اکدي ژبه	Akkadien
څارندوی	Police (institution)
ولسي جرگه	Parlement
اوساکا	Osaka
د کېمبرېج پوهنتون	Université de Cambridge
اجرايي قوه	Pouvoir exécutif
تعمید غسل	Baptême
ډډون	Inflation
سابندي	Asthme
عمر خيام	Omar Khayyam
وله	Saule
محمد علي کلي	Mohamed Ali (boxe anglaise)
خاوره	Sol (pédologie)
اينځر	Ficus carica
ليکوال	Écrivain
د توهوکو سونامي او رېږدله ۲۰۱۱	Séisme de 2011 de la côte Pacifique du Tōhoku
واتسلاف هاول	Václav Havel
د ورېښم لار	Route de la soie
جېن آسټن	Jane Austen
کوردي ژبه	Kurde
زرۍ	Millénaire
علمی نوم	Nom binominal
هنرېک ايبسن	Henrik Ibsen
ماموت	Mammouth
څلورڅنډی	Quadrilatère
د سرکوزي والگی	Grippe porcine
اوزون	Ozone
جذام	Lèpre
مخ (اناتومي)	Visage
خپلواکي	Indépendance (politique)
ښوون	Olivier
سليمان	Salomon (Bible)
یاهو!	Yahoo!
کرښه (مېچپوهنه)	Droite (mathématiques)
فرعون	Pharaon
کلاشېنکوف اې کې ۴۷	AK-47
څپه	Onde
د وینې سره کرویات	Érythrocyte
سند	Sind
فرانسېس بیکن	Francis Bacon (philosophe)
معمولي مندته	Abricotier
نيکول کېډمېن	Nicole Kidman
هايکو	Haïku
عثمان بن عفان	Othmân ibn Affân
وگړشمېرنه	Démographie
ځمکواکي	Féodalité
اوبړۍ	Algue
نتالي پورټمېن	Natalie Portman
هېرټا مولر	Herta Müller
مکډونالډز	McDonald's
يوکوهوما	Yokohama
گړپوهنه	Morphologie (linguistique)
ويليم فاکنر	William Faulkner
هندواڼه	Pastèque
پخلی	Cuisson des aliments
بادي ژرنده	Moulin à vent
د حماس اسلامي غورځنگ	Hamas
آيت الله روح الله خميني	Rouhollah Khomeini
ليزر	Laser
تبه	Fièvre
تيد	Teide
کوچنی وټه	Microéconomie
رجب طيب اردوغان	Recep Tayyip Erdoğan
خزدکپوهنه	Entomologie
تبر	Hache
علي بن ابي طالب	Ali ibn Abi Talib
گورجی سپی	Setter
لویه وټه	Macroéconomie
انسولين	Insuline
بازارموندنه	Marketing
سرشمېرنه	Recensement de la population
ابن رشد	Averroès
لسيزه	Décennie
بادام	Amandier
څښاک	Boisson
نيانډرټال	Homme de Néandertal
الهي کمېډي	Divine Comédie
ووب	Tissu biologique
امير شېر علي خان	Sher Ali Khan
پروېز مشرف	Pervez Musharraf
لوط	Loth
دهاډرونو ستر تعجیل کوونکي ماشین	Large Hadron Collider
يحيی	Jean le Baptiste
دیلما روسف	Dilma Rousseff
ساندرا بللاک	Sandra Bullock
جراحي	Chirurgie
بياتي	Paire de ciseaux
نفرتيتي	Néfertiti
لمونځ	Prière
سکايپ	Skype
غږپوهنه	Phonologie
هارولډ پينټر	Harold Pinter
د حزب الله اسلامی غورځنگ	Hezbollah
باو	Syphilis
د آشور واکمني	Assyrie
ودانۍ	Bâtiment (construction)
سوني	Sony
باريس ولاديميروويچ پاسترناک	Boris Pasternak
کونستانتين اېدواردوويچ تسيولکوفسکي	Constantin Tsiolkovski
سينما	Salle de cinéma
بودجه	Budget
څپواټن	Longueur d'onde
داوود	David (Bible)
کنگل هاکي	Hockey sur glace
کوردستان	Kurdistan
د موس مقياس	Échelle de Mohs
بواسيرونه	Pathologie hémorroïdaire
هېنريک سېنکېويچ	Henryk Sienkiewicz
ککرۍ پتنگ	Sphinx tête de mort
كوكايين	Cocaïne
فینیکیان	Phénicie
شهادت	Chahada
د بابل ځوړند بڼ	Jardins suspendus de Babylone
حاکميت	Souveraineté
خديجه بنت خويلد	Khadija bint Khuwaylid
ام سلمه هند بنت ابي اميه	Oumm Salama bint Abi Oumaya
نیلي نهنگ	Baleine bleue
څېړنه	Recherche scientifique
سولي پرودممه	Sully Prudhomme
اوبپوهنه	Hydrologie
بوکر	Cône (géométrie)
د مورنۍ ژبې نړيواله ورځ	Journée internationale de la langue maternelle
سهيونېزم	Sionisme
د طالبانو اسلامي غورځنگ	Taliban
اناکزیمېنډر	Anaximandre
کورکمن	Curcuma
د مسلمانانو د شمېر له مخې د هېوادونو لړليک	Nombre de musulmans par pays
ځنگلي پيشو	Chaus
عبدالله گل	Abdullah Gül
ختيځپوهنه	Orientalisme
کرېشنا	Krishna
ساباوري	Animisme
مالیه	Finance
وچکالي	Sécheresse
تور مرچ	Poivrier noir
ياقوت	Rubis
کشمير	Cachemire
ټولپوښتنه	Référendum
كپېړ	Crocodylidae
مولانا جلال الدين محمد بلخي	Djalâl ad-Dîn Rûmî
کارغه	Corvus
پلزن	Plzeň
توکمپوهنه	Ethnologie
مټ	Bras (segment de membre)
زمرد	Émeraude
وحشي پيشو	Felis silvestris
شکرخوره	Trochilidae
فدراسيون	État fédéral
شونډکيز چرگ	Dinde
انسلم	Anselme de Cantorbéry
حامد کرزی	Hamid Karzai
یان هوس	Jan Hus
کورني آلو	Prunier
اندرس بېرينگ برېويک	Anders Behring Breivik
شينټاغی	Coraciidae
احمد سلمان رشدي	Salman Rushdie
افسانه	Légende
داریوش ۱	Darius Ier
توت	Mûrier
لسبېله ولسوالۍ	District de Lasbela
اېنټروپي	Entropie (thermodynamique)
ټوبه ټيک سېنگ ولسوالۍ	District de Toba Tek Singh
گجرات ولسوالۍ	District de Gujrat
هرات	Hérat
کودتا	Coup d'État
کندهار	Kandahar
تړمه ييزه پراختیا	Coefficient de dilatation
غشی	Flèche (arme)
غږتاندی	Microphone
امجد خان	Amjad Khan
ابن عربي	Ibn Arabî
توراڼه	Drongo royal
اپيم	Opium
اوسيريس	Osiris
ازاد بازار	Libre marché
اوکاړه ولسوالۍ	District d'Okara
احمد شاه دراني	Ahmad Shâh Durrani
اسراييل لرغونتون	Musée d'Israël
جي اس ام	Global System for Mobile Communications
اېشواريه رای	Aishwarya Rai
نوغپوهنه	Généalogie
مېلټون فرايډمېن	Milton Friedman
بانکنوټ	Billet de banque
نړيواله جنايي محکمه	Cour pénale internationale
رادار	Radar
د اسلامي همکاريو سازمان	Organisation de la coopération islamique
سياسي وټه	Économie politique
د بابل واکمني	Babylone (royaume)
جبران خليل جبران	Gibran Khalil Gibran
روبي وېليمز	Robbie Williams
د سږو سرطان	Cancer du poumon
مهايانا	Bouddhisme mahāyāna
امريتسر	Amritsar
اس ـ ۳۰۰	S-300
مير تشيال تمځی	Mir (station spatiale)
خانيوال ولسوالۍ	District de Khanewal
لنډه کيسه	Nouvelle
د لبنان جگړه ۲۰۰۶	Conflit israélo-libanais de 2006
گرځندويي	Tourisme
شاعر	Poète
بادي توربین	Éolienne
یوسېفینه پرویس	Josefine Preuß
يو گونديز حکومت	Parti unique
مصري ژبه	Égyptien ancien
هارون	Aaron (Bible)
ایبولا ناروغۍ	Maladie à virus Ebola
ژونځمکپوهنه	Biogéographie
غونډ	Régiment
سور كانگرو	Kangourou roux
هارپي	Harpie féroce
ابسيډين	Obsidienne
وېشنيزه:حکومت	Catégorie:Gouvernement
د کيلو کلاس اوبتل	Classe Kilo
سپايس گرلز	Spice Girls
مېزپاسی سولگر	Ordinateur de bureau
پاراستامول	Paracétamol
عبدالله بن عبدالعزیز آل سعود	Abdallah ben Abdelaziz al-Saoud
سيد على خامنه‌اى	Ali Khamenei
امام علي رحمانوف	Emomalii Rahmon
اودو فوګت	Udo Voigt
اسلام کريموف	Islom Karimov
راجا پروېز اشرف	Raja Pervez Ashraf
گيودو ويسترويلي	Guido Westerwelle
پښتو ژبه	Pachto
عرب سمندرگی	Mer d'Arabie
گرمټ	Perceuse
دیو جانس کلبی	Diogène de Sinope
کورنت توغندی	9M133 Kornet
هېرويين	Héroïne
کوفین	Caféine
اندروجن	Androgène
سيمټيکس	Semtex
راوړنې	Importation
ببرک کارمل	Babrak Karmal
حفيظ الله امين	Hafizullah Amin
يوسف عبدالله القرضاوي	Youssef al-Qaradâwî
تريخی	Vésicule biliaire
انتوني هوپکينز	Anthony Hopkins
مرکزي بانک	Banque centrale
جيپور	Jaipur
سيبري پړانگ	Tigre de Sibérie
القلويد	Alcaloïde
آدم	Adam
یوسيف ۲	Joseph II de Habsbourg
ويلهلم لودويگ گايگر	Wilhelm Geiger
کریستوف والڅ	Christoph Waltz
ډورن بورېس اندرېويچ	Bernhard Dorn
رنگين دادفر سپنتا	Rangin Dadfar Spanta
عبدالاحد مومند	Abdul Ahad Mohmand
ښاري انجنيري	Génie civil
وړانگپوهنه	Radiologie médicale
اليگارشي	Oligarchie
زړه گراف	Électrocardiographie
د افغانستان رپی	Drapeau de l'Afghanistan
ايسيس	Isis
ځوانکې	Acné
اېترنټ	Ethernet
چکوتره	Citrus maxima
بشري پوهنې	Lettres (culture)
ټپوس	Milan noir
نهنگی شارک	Requin-baleine
بېنډۍ	Gombo
د سلطان احمد جومات	Mosquée bleue
اټومي بټۍ	Réacteur nucléaire
مايکروسافټ اوټلوک	Microsoft Outlook
بنگالي پړانگ	Tigre du Bengale
مالداري	Élevage
معمولي کپر (کب)	Carpe commune
اولوموڅ	Olomouc
مورفين	Morphine
د صرافی ماشین	Guichet automatique bancaire
نخود	Pois chiche
نوح	Noé (patriarche)
والټ وايټمېن	Walt Whitman
غاښۍ	Fourchette
چوپسټېک	Baguettes (couverts asiatiques)
د خوړو او کرهڼې سازمان	Organisation des Nations unies pour l'alimentation et l'agriculture
براشوف	Brașov
زنه	Menton (partie du visage)
قطبي گيدړ	Renard polaire
سياستوال	Personnalité politique
شپږڅنډی	Hexagone
د افغانستان جگړه (۱۹۷۹-۱۹۸۹)	Guerre d'Afghanistan (1979-1989)
ختيځ هند کمپنۍ	Compagnie britannique des Indes orientales
الكساندر نيكولاېويچ رومانوف	Alexandre II (empereur de Russie)
اسکلېپيوس	Asclépios
ژان اېف کوستو	Jacques-Yves Cousteau
وزير (حکومت)	Ministre
گرو نانک	Guru Nanak
کانپوهنه	Minéralogie
شېنگن تړون	Convention de Schengen
سابه خوړونکي	Végétarisme
امپيدوکلېس	Empédocle
اوېستا	Avesta
ستر جنرال	Général
شاه جهان	Shâh Jahân
شېر شاه سوري	Sher Shah Suri
د الله نومونه	Noms de Dieu en islam
د ساسانيانو واکمني	Sassanides
هوروس	Horus
د افغانستان د کرېکټ ملي لوبډله	Équipe d'Afghanistan de cricket
پولنډبال	Polandball
راټکو مېلادېچ	Ratko Mladić
انځورگري	Dessin
پرېژه	Divorce
باليووډ	Bollywood
اېف – ۱۶	General Dynamics F-16 Fighting Falcon
عبدالله کلا ولسوالۍ	District de Killa Abdullah
کلوژ-ناپوکا	Cluj-Napoca
مرزا حسين علي بهاالله	Mirza Husayn Ali Nuri
نېغ انسان	Homo erectus
ماهر انسان	Homo habilis
هاډرون	Hadron
سوسن	Muguet de mai
اينو	Aïnous (ethnie du Japon et de Russie)
تسپود	Inflammation
بايوم	Biome
لروين	Jumelles
گبين مچۍ	Apis (genre)
آوسټرالوپیتهېکوس	Australopithèque
نړېواله جگړه	Guerre mondiale
روي شنکر	Ravi Shankar (musicien)
چندرۍ	Houblon
کرښی	Règle (instrument de géométrie)
قضايي قوه	Pouvoir judiciaire
ماگنوس کارلسن	Magnus Carlsen
مرزا اسد الله خان غالب	Mirza Ghalib
خاښۍ	Fourche
ايالت	État fédéré
کندوز	Kondôz (ville)
د افغانستان د ښارونو لړليک	Villes d'Afghanistan
انجه	Ase fétide
مارشال	Maréchal (armée)
انټيکولينرجيک	Anticholinergique
مالي کړکېچ	Crise financière
هزاره گان	Hazaras
کريم خليلي	Karim Khalili
سليكان ډای اکسايډ	Dioxyde de silicium
کورکورکه	Tourterelle tigrine
د وېلسن ناروغي	Maladie de Wilson
ابن قيم الجوزي	Ibn Qayyim al-Jawziyya
الكساندر الكساندروويچ رومانوف	Alexandre III (empereur de Russie)
بلخ ولايت	Balkh (province)
مشهد	Mashhad
رنځورپالنه	Soin infirmier
پاکپتن ولسوالۍ	District de Pakpattan
ټولنیزه ولسواکي	Social-démocratie
د ستنې طب	Acupuncture
سفارت	Ambassadeur
کجير	Vautour
عقيق	Agate
اپلاتون او دولت	La République
ارستوکراسي	Aristocratie
پوځي څارگره اداره (د چېک جمهوريت)	Vojenské zpravodajství
زکات	Zakât
ميرمشاه	Miranshah
گيورگې ژوکوف	Gueorgui Joukov
د اوبو چينه	Source (hydrologie)
بڼ پالنه	Jardinage
وېليم جېمز	William James
غوڅندۍ	Scie
سورلنډی	Chacal
د موسم بدلون	Changement climatique
واټن	Distance (mathématiques)
د افغاني تلويزونونو لړليک	Télévision en Afghanistan
کوباني	Kobané
پراگماتيزم	Pragmatisme
وړکتون	École maternelle
ابن ميمون	Moïse Maïmonide
شين یاقوت	Saphir
پينځڅنډی	Pentagone
ټوټالېټر	Totalitarisme
کوچيان	Nomadisme
درملپوهنه	Pharmacologie
د زیات شوي ارزښت ورکړېنه	Taxe sur la valeur ajoutée
خټنه	Viscosité
لوي سپين شارک	Grand requin blanc
د جمشید پلاز	Persépolis
انتراکس	Maladie du charbon
خشايارشا	Xerxès Ier
مزار شريف	Mazâr-e Charîf
مېگ ۲۹	Mikoyan-Gourevitch MiG-29
د ذرو تعجيل کوونکي ماشين	Accélérateur de particules
ډیمېټروډون	Dimétrodon
سپاینوسور	Spinosaurus
بېیپیاوساوروس	Beipiaosaurus
خلافت	Califat
معمولي آلوبالو	Prunus cerasus
زغوپرواژی	Pesticide
ډومنيک ډي وېلپين	Dominique de Villepin
د قم ولايت	Province de Qom
گڼرسنۍ	Multimédia
کوروند	Corindon
سریښ	Colle
والي	Gouverneur
توکمکښنه	Ethnographie
کرما په هندويزم کې	Karma
آيورويدا	Ayurveda
د جال تړونونه	Protocole de communication
جوليوس روبرټ اوپنهايمر	Robert Oppenheimer
باختر	Bactriane
هېروگليف	Écriture hiéroglyphique égyptienne
ولاديمير ولاديميروويچ ماياکوفسکي	Vladimir Maïakovski
د هند پېښليک	Histoire de l'Inde
مستعمره	Colonie
ملخوزه	Fenugrec
اخوان المسلمون	Frères musulmans
تومور	Tumeur
الياس	Élie
طاعون	Peste
د سېټريک اسيد څرخ	Cycle de Krebs
دهرما	Dharma
ټاسماني شيطان	Diable de Tasmanie
توپاز	Topaze (minéral)
۹×۱۹ مرمی	9 × 19 mm Parabellum
آندروختونوس اوسترالیس	Androctonus australis
قادريه	Qadiriyya
د ايران ولسوالۍ	Préfectures de l'Iran
ابد	Éternité
عبدالعلي مزاري	Abdul Ali Mazârî
میرمېسیا پیلوسولا	Myrmecia pilosula
زابل ولايت	Zabol (Afghanistan)
زکريا	Zacharie (père de Jean le Baptiste)
مسراشمیت مې-۲۶۲	Messerschmitt Me 262
ازاد شعر	Vers libre
شگموښی	Papier de verre
ايليوشين-۷۶	Iliouchine Il-76
فرایشتات	Freistadt
زينب بنت خزيمه	Zaynab bint Khouzayma
هربرټ سپېنسر	Herbert Spencer
زلمی خليلزاد	Zalmay Khalilzad
شاه زمان خان	Zaman Shâh
سارک	Association sud-asiatique pour la coopération régionale
يوسف	Joseph (fils de Jacob)
د لويديځ سلاوي ژبې	Langues slaves occidentales
اروپايي صنوبر	Épicéa commun
شين صنوبر	Épicéa bleu
چمبل	Viola (genre végétal)
پولي ونيل کلورايډ	Polychlorure de vinyle
نانگه	Ribes rubrum
قبطيان	Coptes
نارنج	Bigaradier
اناناس	Ananas (genre)
کاجول	Kajol
ايگلا	9K38 Igla
ځنگلي مېږی	Formica rufa
مېگ ۳۱	Mikoyan-Gourevitch MiG-31
پښيميسل اوتاکار ۲	Ottokar II de Bohême
رودلف ۲ هابسبورگ	Rodolphe II de Habsbourg
ميانې	Dhou al qi`da
عبد العزيز بن عبدالرحمن بن فيصل آل سعود	Abdelaziz ben Abderrahmane al-Saoud
دېوالي	Cessation de paiements
بوغمه	Œdème
محمد ظاهر شاه	Mohammad Zaher Shah
ډگر جنرال	Lieutenant-général
بريد جنرال	Général de brigade
سيف الله کلا ولسوالۍ	District de Killa Saifullah
البرخت فون والدشتاین	Albrecht von Wallenstein
امير امان الله خان	Amanullah Khan
محمود طرزي	Mahmoud Tarzi
سکندر مرزا	Iskander Mirza
عمران خان	Imran Khan
یان لوگزامبورگ	Jean Ier de Bohême
روهتاس	Fort de Rohtas
جيارډيا لامبليا	Giardia intestinalis
ميل می ۸	Mil Mi-8
مېسرشمېت بي اف ۱۰۹	Messerschmitt Bf 109
مسراشمیت بي اف ۱۱۰	Messerschmitt Bf 110
یوزي	Uzi
ريچارډ هولبروک	Richard Holbrooke
ميل می ۲۴	Mil Mi-24
ايساف	Force internationale d'assistance et de sécurité
ټې-۷۲	T-72
یونکرس یو ۸۸	Junkers Ju 88
کارل ۴	Charles IV (empereur des Romains)
مېگ ۲۳	Mikoyan-Gourevitch MiG-23
ارهنډه	Ricin commun
اېرو ال-۳۹ الباتروس	Aero L-39 Albatros
نېښ لرونکي بوټي	Grande ortie
ټېنوفووير	Ténofovir
د آلمان ملي دموکراتیک گوند	Parti national-démocrate d'Allemagne
رشقه	Luzerne cultivée
لتا منگېشکر	Lata Mangeshkar
سره غوړیانه	Lis martagon
ادميرال پتنگ	Vulcain (papillon)
فيض آباد (بدخشان)	Fayzabad
ځريځه	Carthame des teinturiers
محمد رفيع	Mohammed Rafi
تورن جنرال	Major-général
گزک بوټي	Plantago lanceolata
ال – ۴۱۰	Let L-410 Turbolet
تبو	Tabu
ډمپل کپاډيا	Dimple Kapadia
غوماشی	Anophèle
د افغانستان ولايتونه	Province de l'Afghanistan
تاووس پتنگ	Paon du jour
جوهي چاولا	Juhi Chawla
پريانکا چوپړا	Priyanka Chopra
ويديا بالان	Vidya Balan
لاکهيډ مارتين آر کيو ۱۷۰ سېنټينل	RQ-170 Sentinel
ناصر الدين شاه قاجار	Nasseredin Shah
سپما گڼون	Compte d'épargne
د اس وې ډې دراگونوف ټوپک	SVD
یرژي پوديېبراد	Georges de Bohême
وټه	Économie
د ځمکې گړۍ	Earth Hour
رام	Rāma
محمد علی جناح	Muhammad Ali Jinnah
وچکۍ تبه (محرقه)	Typhus
اتره	Tronc (anatomie)
توت خوره	Fringillidae
شاتوت	Mûrier noir
سنځله	Elaeagnus
ښاريتوب	Urbanisation
غونجېدنه (وټپوهنه)	Déflation
خپلپالنه	Népotisme
باور کارټ	Carte de crédit
پامير	Pamir
وېلنی	Menthe sylvestre
سيسۍ	Lagopède
سرطانپوهنه	Oncologie
گلايکوليسېز	Glycolyse
شکودا فابيا	Škoda Fabia
گایوس واليریوس کاتولوس	Catulle
بلوچستان (پاکستان)	Baloutchistan (Pakistan)
غالۍ	Tapis
موزيکپوهنه	Musicologie
ليندۍ	Capricorne (astrologie)
ابسه	Abcès
گانډۍ	Ruche
کدو	Citrouille
د کرمان ولايت	Province de Kerman
بدخشان ولايت	Badakhchan (Afghanistan)
لیکاڼۍ	Stylo
اتڅنډی	Octogone
مچ	Mouche domestique
وړانديز (وټپوهنه)	Offre et demande
پارلماني حکومت	Régime parlementaire
برغټ	Chat de Pallas
چمپا	Magnolia champaca
محمد محقق	Haji Mohammad Mohaqiq
نگوس	Stéréotype
تېمور شاه دراني	Timour Shah Durrani
نورستان ولايت	Nouristan
محمد قسيم فهيم	Mohammed Fahim Khan
ډولومیت	Dolomite
جابر بن حیان	Jabir Ibn Hayyan
بورقه	Burqa
کرايووا	Craiova
کورکوری	Tourterelle des bois
روحانيت	Spiritualité
انافلاکسي	Choc anaphylactique
د اسلام انبیاء	Prophètes de l'islam
لاسپېله	Gant
محمد زکريا رازي	Rhazès
مېترونيدازول	Métronidazole
گرافېن	Graphène
رنځېږن	Agent infectieux
ليکپاکټ	Enveloppe (papeterie)
کانفدراسيون	Confédération (organisation politique)
ټي اېن ټي	Trinitrotoluène
چېکيان	Tchèques
بغلان ولايت	Baghlân (province)
ابټ آباد	Abbottabad
بدن	Corps (biologie)
يزد ولايت	Province de Yazd
قم	Qom
توماس اېډورډ لارېنس	Thomas Edward Lawrence
بيولوژيکي وسلې	Arme biologique
ټېغکه	Laniidae
عباس ۱	Abbas Ier le Grand
باميان ولايت	Bâmiyân (province)
ای اچ ۶۴ آباچی	Boeing AH-64 Apache
لمرگلی	Tournesol
د سهېلي خراسان ولايت	Khorasan méridional
پېښه	Accident
کرمان	Kerman
احمديت	Ahmadisme
د اگرې کلا	Fort d'Agra
د مذهب خپلواكي	Liberté de religion
تيتر	Pintade
ځانگړواله	Individualisme
بادغيس ولايت	Bâdghîs
قبة الصخرة جومات	Dôme du Rocher
اشرف غني احمدزی	Ashraf Ghani
رېبز	Balai
ټوپولف ټو-۱۵۴	Tupolev Tu-154
نړیواله پېغله	Miss Monde
آټوکراسي	Autocratie
خواړه ساتنه	Conservation des aliments
مارگريت ميتچېل	Margaret Mitchell
آرگېنين	Arginine
سوخوی سو ٢٧	Soukhoï Su-27 Flanker
ام۱ آبرامس	Char M1 Abrams
غزني	Ghazni (ville)
وختتېری	Divertissement
کندهار ولايت	Kandahâr (province)
کاپيسا ولايت	Kâpîssâ
هلمند ولايت	Helmand (province)
فارياب ولايت	Fâryâb
محراب	Mihrab
د الازهر پوهنتون	Université al-Azhar
بوتل پزی څوڅ	Grand dauphin
اوسېلوسکوپ	Oscilloscope
توحيد	Tawhid
بي-٥٢ سټراټوفورټرېس	Boeing B-52 Stratofortress
کوډيين	Codéine
قبله	Qibla
فتح علي شاه قاجار	Fath Ali Shah Qajar
بېديانۍ پيشو	Chat des sables
تانبه:تاریخ	Portail:Histoire
واتسلاف ۱	Venceslas Ier de Bohême (roi)
د اسلام پنځه بنسټونه	Piliers de l'islam
زوی	Fils (parenté)
سکاره	Charbon de bois
شنقار	Faucon gerfaut
د ژونکې تيوري	Théorie cellulaire
فولېرېن	Fullerène
نېکروسېز	Nécrose
د واشنگټن څلی	Washington Monument
آنتونوف-۲۲۵	Antonov An-225
وييپوهنه	Lexicologie
ننگرهار ولايت	Nangarhâr
درونکښ	Grue (engin)
روژه	Saoum
کاني اوبه	Eau minérale naturelle
نولۍ	Furet
لگښت ساتنې تگلاره	Protectionnisme
آنتیستنس	Antisthène
مرکزي حکومت	État unitaire
د پاکستان په شمال لویدیځ کې جگړه	Conflit armé du Nord-Ouest du Pakistan
اسماني کتابونه او صحيفې	Texte sacré
ژبساپوهنه	Psycholinguistique
اوبزمکپوهنه	Hydrogéologie
د مزلو د اړتیاوو د مرتبو سلسله	Pyramide des besoins
د بازار وټه	Économie de marché
اپیکوریزم	Épicurisme
اورمازده	Ahura Mazda
درملنه	Traitement (médecine)
اريايان	Aryens
يعقوب کندي	Al-Kindi
گورجېس	Gorgias
سياسي فلسفه	Philosophie politique
جوهر دوداییف	Djokhar Doudaïev
ايوب	Job (Bible)
د افغانستان ولسي لاره	Milli Tharana
اېکونومېسټ	The Economist
تورگوت اوزال	Turgut Özal
نورتورپ گرومان بي ۲ سپېريټ	Northrop B-2 Spirit
لمريز لېږديز کليز	Calendrier persan
فراه ولايت	Farâh (province)
غزني ولايت	Ghazni (province)
راشدين خليفه گان	Rachidun
وړانگدرملنه	Radiothérapie
کوټه	Salle
شاپ	Suppositoire
پوهنځی	Faculté (éducation)
نکوټي يانا ټیبېکم	Nicotiana tabacum
بلوچستان	Baloutchistan
سيد حسن نصرالله	Hassan Nasrallah
دايکندي ولايت	Deykandi
پنجشېر ولايت	Pandjchir
زړه نابری	Insuffisance cardiaque
ټوپولف ټو-۹۵	Tupolev Tu-95
د جانسي راني	Lakshmî Bâî
بلخ	Balkh
امونيم نايټرېټ	Nitrate d'ammonium
آسيايي زمري	Lion asiatique
کامبوجيه ۲	Cambyse II
سرپل ولايت	Sar-é Pol (province)
پکتيا ولايت	Paktiyâ
خوارزم	Khwarezm
بهرونه	Exportation
ايټا جېمز	Etta James
كنسرټ	Concert
هرات ولايت	Hérât (province)
سمنگان ولايت	Samangân (province)
نيمروز ولايت	Nimrôz
روزگان ولايت	Orozgân
جوزجان ولايت	Djôzdjân
ميدان وردگ ولايت	Wardak
کورکوړۍ	Meropidae
شننيزه فلسفه	Philosophie analytique
سېموېل کولټ	Samuel Colt
جلالکوټ	Jalalabad
خيبر پښتونخوا	Khyber Pakhtunkhwa
سينوسايټس	Sinusite
موکشا	Moksha
اسماعيل	Ismaël
نسخوږی	Douleur abdominale
زينت امان	Zeenat Aman
لسڅنډی	Décagone
چينايي فلسفه	Philosophie chinoise
بوينگ بي ۲۹	Boeing B-29 Superfortress
کرينه کپور	Kareena Kapoor
بوينگ بي ۱۷ فلاينگ فورټرېس	Boeing B-17 Flying Fortress
اسيډوسېز	Acidose
اوبي ژرنده	Moulin à eau
فلېپيني عقاب	Aigle des singes
لغمان ولايت	Laghmân
مولتان	Multan
کوټه (ښار)	Quetta
پکتيکا ولايت	Paktîkâ
خوست ولايت	Khôst (province)
جلال الدين حقاني	Djalâlouddine Haqqani
د لوی اختر مياشت	Dhou al-hijja
بريدمن	Lieutenant (grade militaire)
علي اکبر هاشمي رفسنجاني	Hachemi Rafsandjani
ايمن الظواهري	Ayman al-Zaouahiri
رنځورپاله	Infirmier
غور ولايت	Ghôr
تخار ولايت	Takhâr
کندوز ولايت	Kondôz (province)
د پاکستان د خلکو گوند	Parti du peuple pakistanais
د اتریش د خلک ګوند	Parti populaire autrichien
ايبوپروفېن	Ibuprofène
کارسک گيدړ	Vulpes corsac
ابهيشېک بچچن	Abhishek Bachchan
سالنډي	Dyspnée
کونړ ولايت	Kounar
پروان ولايت	Parwân
آيت	Aya (islam)
قول اردو	Corps d'armée
ايمفيسېما	Emphysème pulmonaire
احمد ياسين	Ahmed Yassine
برهان الدين رباني	Burhanuddin Rabbani
پريټي زېنتا	Preity Zinta
صحابه	Sahaba
سمایلوډون	Smilodon
اوڅنډی	Heptagone
د افغانستان پېښليک	Histoire de l'Afghanistan
کابل ولايت	Kaboul (province)
ټېډ	Conférence TED
آندری کاراطايف	Andreï Korotaïev
سلطان محمود غزنوي	Mahmoud de Ghaznî
د زړه ارېتميا	Trouble du rythme cardiaque
پینټریټ	Tétranitrate de pentaérythritol
اسلامي هنر	Arts de l'Islam
اسلامپالنه	Islamisme
پوښتنه	Interrogation (linguistique)
هیکسوجن	RDX
ميناتو	Minato-ku (Tokyo)
وزيرستان	Waziristan
اوښلن لوگی	Gaz lacrymogène
کوستا کونکورديا	Costa Concordia
ابو حنيفه (امام اعظم)	Abû Hanîfa
مرکاوا شوبله	Merkava
جوهر	Essence et accident
ټوپولف ټو-۱۶۰	Tupolev Tu-160
شيطاني آيات	Les Versets sataniques
خيبر دره	Passe de Khyber
شاپور ۱	Shapur Ier
سيلدينافيل	Sildénafil
تکبیر	Allahou akbar
مالي کال	Exercice fiscal
سوخوی سو-۲۵	Soukhoï Su-25
پرولاکټين	Prolactine
ټانگتوره	Datura
تیسفون	Ctésiphon
ډېلي ټيليگراف	The Daily Telegraph
سټرېپټومايسين	Streptomycine
هندي څمڅه منگور	Cobra indien
ټې-۹۰	T-90
نادر شاه افشار	Nâdir Châh
د بوټي هورمون	Phytohormone
ټېټراسايکلين	Tétracycline
اسلامي فلسفه	Philosophie islamique
سبسيډي	Subvention
د پراگ کلا	Château de Prague
آنتونوف-۱۲۴	Antonov An-124
هود	Houd
خړانکه	Anthus
ملا محمد عمر	Mohammad Omar
فريد الدين عطار	Farid al-Din Attar
د خدای پاک مياشت	Rajab
کړنی سېک	Potentiel d'action
امام احمد بن حنبل	Ahmad Ibn Hanbal
سوخوی پک فا	Soukhoï T-50
احمد ظاهر	Ahmad Zahir
کابل بانک	Kabul Bank
شاهرخ افشار	Shâhrokh Châh
ام کيو-۱ پرېډاټور	MQ-1 Predator
کوږوږ	Zigzag
زيډووډين	Zidovudine
محمد يونس خالص	Mohammed Younès Khalid
بديع الزمان سعيد نورسي	Saïd Nursî
گلروزنه	Floriculture
افغانۍ	Afghani
مېگ ۲۵	Mikoyan-Gourevitch MiG-25
د سږو اوندنه خنډيزه ناروغي	Bronchopneumopathie chronique obstructive
احمد شاه مسعود	Ahmed Chah Massoud
داسو میراژ- ۲۰۰۰	Dassault Mirage 2000
نهڅنډی	Ennéagone
آزاد کشمير	Azad Cachemire
اوبسپی	Loutre
چينايي دوديزه درملگري	Médecine traditionnelle chinoise
گېلگېت بالتستان	Gilgit-Baltistan
بلوڅان	Baloutches
ټراک	Fauvette des jardins
کېټ وېنسلېټ	Kate Winslet
نيوموتوراکس	Pneumothorax
اورو لانکاسټر	Avro Lancaster
رمضان بشردوست	Ramazan Bashardost
لرغونې فلسفه	Philosophie antique
زين العابدين بن علي	Zine el-Abidine Ben Ali
غرزي	Ghilzai
يوني ماشين	Moteur ionique
نېټه	Date
ایزو ۹۰۰۰	Série des normes ISO 9000
اليسع	Élisée
معمولي څوڅ	Dauphin commun à bec court
ترچ مير	Tirich Mir
مطبوعاتي اعلاميه	Communiqué de presse
محمد نجيب الله	Mohammed Nadjibullah
غوز	Noix
زنځيري غوڅندۍ	Tronçonneuse
فدرالي قبايلي سيمې	Régions tribales (Pakistan)
گونگه ښارو	Bombycillidae
د مذهب فلسفه	Philosophie de la religion
ډايازيپم	Diazépam
سوخوی سو-۲۴	Soukhoï Su-24
کورټيکوسټېرويډ	Corticoïde
غوږور ښاپېرک	Plecotus auritus
چندړ	Santalum album
سيد قطب	Saïd Qotb
بوکو حرام	Boko Haram
السلام عليکم	Assalamu alaykum
خسرو پرويز	Khosro II
اېنډوسکوپي	Endoscopie
طبله	Tabla
غونډل	Theraphosidae
گندهارا	Gandhara
کوډېکس	Codex
يان ژيژکا	Jan Žižka
يوم	Bêche
ستره لوبه	Grand Jeu (géostratégie)
لاجورد	Lapis-lazuli
مقتدی الصدر	Moqtada al-Sadr
چت	Plancher
يزيد بن معاويه	Yazīd Ier
آلانين	Alanine
احمد ضيا مسعود	Ahmed Zia Massoud
ښکلي هنرونه	Beaux-arts (disciplines)
افدرين	Éphédrine
ای اچ ۱ کبرا	Bell AH-1 Cobra
سورة الفاتحة	Al-Fatiha
سورة البقرة	Al-Baqara
سورة آل عمران	Al-Imran
سورة النساء	An-Nisa
سورة المائدة	Al-Ma'ida
سورة الأنعام	Al-An'am
سورة الأعراف	Al-A'raf
سورة الأنفال	Al-Anfal (sourate)
سورة التوبة	At-Tawba
سورة يونس	Yunus (sourate)
سورة هود	Hud (sourate)
سورة يوسف	Yusuf (sourate)
سورة الرعد	Ar-Ra'd
سورة إبراهيم	Ibrahim (sourate)
سورة الحجر	Al-Hijr (sourate)
جنگسالار	Seigneur de guerre
سورة النحل	An-Nahl
د سږو امبولي	Embolie pulmonaire
ښي لاسی او کيڼ لاسی ترافيک	Sens de circulation (route)
سورة الاسراء	Al-Isra
سورة الكهف	Al-Kahf
سورة مريم	Maryam (sourate)
سورة طه	Ta-Ha
سورة الأنبياء	Al-Anbiya
سورة الحج	Al-Hajj
سورة المؤمنون	Al-Mu'minun
سورة النور	An-Nur
برات	Chaabane
سورة الفرقان	Al-Furqan
سورة الشعراء	Ach-Chu'ara
سورة النمل	An-Naml
سورة القصص	Al-Qasas
سورة العنکبوت	Al-'Ankabut
سورة الروم	Ar-Rum
De Havilland Mosquito	De Havilland DH.98 Mosquito
کيشپ	Tortue
شکودا اوکټاويا	Škoda Octavia
سټېنگر FIM-92	FIM-92 Stinger
سورة لقمان	Luqman (sourate)
دماغي مړينه	Mort cérébrale
مخ (چاپي رسنۍ)	Page
د وټيزو همکاريو سازمان	Organisation de coopération économique
هېوادپال	Patriote
شوننېزم	Chauvinisme
امريکا غږ	Voice of America
درې بعدي چاپگر	Impression tridimensionnelle
سورة السجدة	As-Sajda
سورة الاحزاب	Al-Ahzab
سورة سبأ	Saba (sourate)
سورة فاطر	Fatir
سورة يس	Ya Sin
مامولکه	Motacilla
سورة الصافات	As-Saaffat
سورة ص	Sad (sourate)
سورة الزمر	Az-Zumar
سورة غافر	Al-Ghafir
حسن البنا	Hassan el-Banna
سورة فصلت	Fussilat
سورة الشورى	Ash-Shura
سورة الزخرف	Az-Zukhruf
سورة الدخان	Ad-Dukhan
سورة الجاثية	Al-Jathiya
سورة الأحقاف	Al-Ahqaf
سورة محمد	Muhammad (sourate)
سورة الفتح	Al-Fath
سورة الحجرات	Al-Hujraat
سورة ق	Qaf (sourate)
سورة الذاريات	Adh-Dhariyat
ډېل کارنېگي	Dale Carnegie
سورة الطور	At-Tur (sourate)
سورة النجم	An-Najm
روح الله نېکپا	Rohullah Nikpai
سورة القمر	Al-Qamar
سورة الرحمن	Ar-Rahman
سورة الواقعة	Al-Waqi'a
سورة الحديد	Al-Hadid
سورة المجادلة	Al-Mujadila
سورة الحشر	Al-Hachr
سورة الممتحنة	Al-Mumtahina
سورة الجمعة	Al-Jumua
سورة المنافقون	Al-Munafiqoon
سورة التغابن	At-Taghabun
سورة الطلاق	At-Talaq
سورة الملک	Al-Mulk
سورة القلم	Al-Qalam
سورة الحاقة	Al-Haaqqa
سورة المعارج	Al-Maarij
مېتی	Pioche
مادهوري ډکشټ	Madhuri Dixit
سورة نوح	Nuh
سورة الجن	Al-Jinn
سورة المزمل	Al-Muzzammil
جامنو	Jamelonier
سورة المدثر	Al-Muddathir
سورة القيامة	Al-Qiyama
سورة الإنسان	Al-Insan
سورة المرسلات	Al-Mursalat
سورة النبأ	An-Naba
سورة النازعات	An-Naziat
سورة عبس	Abasa
سورة التكوير	At-Takwir
سورة الانفطار	Al-Infitar
سورة المطففين	Al-Mutaffifin
سورة الانشقاق	Al-Inshiqaq
سورة البروج	Al-Buruj
سورة الطارق	At-Tariq
سورة الأعلى	Al-Ala
سورة الغاشية	Al-Ghashiya
سورة الفجر	Al-Fajr
سورة الشمس	Ash-Shams
سورة الليل	Al-Layl
سورة الضحى	Ad-Dhuha
سورة الشرح	Al-Inshirah
د ماغزو تومور	Tumeur du cerveau
سورة التين	At-Tin
د پاني پت دوهمه جگړه	Deuxième bataille de Panipat
د افغان-انگرېز دويمه جگړه	Seconde guerre anglo-afghane
سورة العلق	Al-'Alaq
سورة القدر	Al-Qadr
سورة البينة	Al-Bayyina
سورة الزلزلة	Al-Zalzala
سورة العاديات	Al-Adiyat
سار	Buse féroce
سورة القارعة	Al-Qaria
سورة التکاثر	At-Takathur
سورة العصر	Al-Asr
سورة الهمزة	Al-Humaza
اکشې کمار	Akshay Kumar
سورة الفيل	Al-Fil
سورة قريش	Quraish (sourate)
سورة الماعون	Al-Ma'un
سورة الکوثر	Al-Kawthar
سورة الکافرون	Al-Kafirun
سورة النصر	An-Nasr
مکه معظمه	La Mecque (province)
سورة المسد	Al-Massad
سورة الإخلاص	Al-Ikhlas
سورة الفلق	Al-Falaq
سپين توت	Morinda citrifolia
سورة الناس	Al-Nas
سورت	Sourate
د هند کمونیست گوند (مارکسیست)	Parti communiste d'Inde (marxiste)
حديث	Hadîth
شاپور ۲	Shapur II
حج	Hajj
رسول	Rasoul
سورة الصف	As-Saff
سورة التحريم	At-Tahrim
ټې-۸۰	T-80
ان هيداوې	Anne Hathaway (femme de Shakespeare)
لونيک	Lunaria annua
امام بخاري	Mouhammad al-Boukhârî
ميل مي - ۲۸	Mil Mi-28
ديکلوفيناک	Diclofénac
سوخوی سو ۳۵	Soukhoï Su-35
پيچکاري	Injection (médecine)
د غزنويانو ټولواکمني	Ghaznévides
اواران ولسوالۍ	District d'Awaran
بارخان ولسوالۍ	District de Barkhan
ابن طفيل	Ibn Tufayl
آسي ژرنده	Manège (machine)
ملالۍ جويا	Malalai Joya
فيفا	Fédération internationale de football association
سوشميتا سېن	Sushmita Sen
ليلا علي	Laila Ali
هېنري مورټېمر ډيورنډ	Mortimer Durand
رابعه بصري	Rabia al Adawiyya
بېنزيل پېنيسيلين	Benzylpénicilline
ريشي کپور	Rishi Kapoor
۳۹×۷،۶۲ مرمی	7,62 × 39 mm M43
د گندمک تړون	Traité de Gandomak
ږدن	Millet (graminée)
سيما ثمر	Sima Samar
حفصه بنت عمر بن خطاب	Hafsa bint Omar
اميشا پټېل	Ameesha Patel
صفيه بنت حيي بن اخطب	Safiya bint Houyay
حاد مايلوييد ليوکېمي	Leucémie aiguë myéloblastique
حاد کرونري ساينډروم	Syndrome coronarien aigu
د کارلشتین کلا	Karlštejn
اروپايي اوښاره	Mante religieuse
پلسيوسور	Plesiosauria
کاموف کا ٥٠	Kamov Ka-50
گڼ پوهيال	Polymathie
شري دېوي	Sridevi
د سپاه پاسداران انقلاب اسلامی ځواک	Corps des Gardiens de la révolution islamique
آنتونوف-۱۲	Antonov An-12
نوشاخ	Nowshak
خبري غونډه	Conférence de presse
ايليوشين-۹۶	Iliouchine Il-96
خټگري	Maçonnerie
بسم الله الرحمن الرحيم	Basmala
دويمه خور	Rabia ath-thani
کلورامفينيکول	Chloramphénicol
انټر سرويس انټېلېجنس (ISI)	Inter-Services Intelligence
د چېک پوځ	Forces armées tchèques
کيچ ولسوالۍ	District de Kech
چاغي ولسوالۍ	District de Chagai
اېسټروجن	Œstrogène
ټاټرا کا ټي – ۸	Tatra KT8D5
HACCP	Analyse des dangers et points critiques pour leur maîtrise
غزل	Ghazal
سوابۍ ولسوالۍ	District de Swabi
شهاب الدين سهروردي	Sohrawardi
مېگانېورا	Méganeura
محمد اسماعيل خان	Ismail Khan
دېره اسماعيل خان ولسوالۍ	District de Dera Ismail Khan
د پاکستان د انصاف غورځنگ	Mouvement du Pakistan pour la Justice
عبدالله بن عمر البيضاوي	Al Baidawi
اېرېسوس موراویکوس	Eresus moravicus
د ډيورنډ کرښه	Ligne Durand
چنگو	Vanellinae
يعقوب	Jacob
لارا دتا	Lara Dutta
الجاحظ	Al-Jahiz
امام شافعي	Ash-Shâfi'î
سيد جمال الدين افغاني	Djemâl ad-Dîn al-Afghâni
نصرت فتح علي خان	Nusrat Fateh Ali Khan
نور محمد ترکی	Nour Mohammad Taraki
اباکاوير	Abacavir
سادات	Sayyid
د راديوايزوټوپونو ترموبريښنایی جنريټر	Générateur thermoélectrique à radioisotope
آلانين ټرانس امينېز	Alanine aminotransférase
ايبټ اباد ولسوالۍ	District d'Abbottabad
ختيځي مچۍ	Apis cerana
ختيځه فلسفه	Philosophie orientale
اروپایی زرغون څرموښکۍ	Lacerta viridis
عبدالقادر گيلاني	Abd al Qadir al-Jilani
عبدالله عزام	Abdallah Azzam
لور	Fille (parenté)
عبدالکريم سروش	Abdolkarim Soroush
ميمنه ولسوالۍ	Maïmana
الشباب	Al-Shabbaab
سردار محمد داود خان	Mohammed Daoud Khan
عبدالقدير خان	Abdul Qadeer Khan
سلطان قطب الدين ايبک	Qûtb ud-Dîn Aibak
پلازموډيم وايوېکس	Plasmodium vivax
بيټالکټمېز	Bêta-lactamase
د قدس ځواک	Force Al-Qods
پلازموډيم فالسيپارم	Plasmodium falciparum
امام مالک بن انس	Mâlik ibn Anas
نورالدين عبدالرحمن جامي هروي	Djami
عمران خان (لوبگر)	Imran Khan (acteur)
رودکي	Rudaki
خان عبدالغفار خان	Khan Abdul Ghaffar Khan
غزی	Himantopus
عبدالرحيم وردگ	Abdul Rahim Wardak
عبدالرشيد غازي	Abdul Rashid Ghazi
عبدالصبور فريد کوهستاني	Abdul Saboor Farid
خان عبدالولي خان	Khan Abdul Wali Khan
عبدالله عبدالله	Abdullah Abdullah
جرمېن جېکسن	Jermaine Jackson
ابن حزم اندلسي	Ibn Hazm
والېري ولاديميروويچ پولياکوف	Valeri Poliakov
گلبدين حکمتيار	Gulbuddin Hekmatyar
احمد شاه قاجار	Ahmad Shah Qajar
عبدالرحمن السديس	Abdul Rahman Ibn Abdul Aziz Al-Sudais
ژولرغونپوهنه	Archéozoologie
مېلبورن پوهنتون	Université de Melbourne
داسو میراژ اف‌۱	Dassault Mirage F1
دېو انند	Dev Anand
آر پي جي-۷	RPG-7
آغا محمد خان قاجار	Agha Mohammad Shah
صالح	Sâlih
د ۲ کا ۱۲ کوب راکټی سیستم	SA-6 Gainful
کنکه لېږندويه انسېفلايټس	Encéphalite à tiques
د افغانستان جگړه (۲۰۰۱)	Opération Enduring Freedom
اس-۲۰۰	S-200 Angara/Vega/Dubna
قانوني لاسوندونه	Acte juridique
ويي جوړښت	Formation des mots
تايروکسين	Triiodothyronine
ادريس	Idris (prophète)
د سولې نړيواله ورځ	Journée internationale de la paix
روماتولوجي	Rhumatologie
ناصر خسرو	Nasir e Khosraw
شپې ليد سترگۍ	Jumelles de vision nocturne
پادشاهی جومات	Mosquée Royale
عبدالرشيد دوستم	Abdul Rachid Dostom
ذوالکفل	Dhul Kifl
کريم خان زند	Mohammad Karim Khân
رنجيت سېنگ	Ranjît Singh
فخر الدين رازي	Fakhr ad-Dîn ar-Râzî
اپورتونېزم	Opportunisme
شمي کپور	Shammi Kapoor
امير حبيب الله خان	Habibullah
کمال الدين بهزاد	Behzad
بيت الله محسود	Baitullah Mehsud
ابوبکر	Abou Bakr As-Siddiq
ابو مسلم خراساني	Abu Muslim al-Khurasani
جيورج ايډېن	George Eden
سلطان علاوالدين غلجی	Alâ ud-Dîn Khaljî
کاشي	Glaçure
تفسير	Tafsir
گوگل	Médiastin
راجپوت	Rajput
آیت الله سيستاني	Ali al-Sistani
صليبي غڼه	Épeire diadème
چورليځ	Axis
محمد علي شاه قاجار	Mohammad Ali Shah
فرانسېس يسېدرو اېجورت	Francis Ysidro Edgeworth
محمد نادر شاه	Mohammad Nadir Shah
آنتونوف-۱۴۰	Antonov An-140
سلمان ابن عبدالعزیز آل سعود	Salmane ben Abdelaziz al-Saoud
پټه لرونکی ژگاگ	Mouffette rayée
سليووويټز	Slivovitz
ابو الاعلى مودودي	Sayyid Abul Ala Maududi
عروض	Métrique arabe
اردشیر پاپاکان	Ardachîr Ier
هېماټويوريا	Hématurie
جده	Djeddah
د چين نړيواله راډيو	Radio Chine Internationale
الېکسانډر برنېس	Alexander Burnes
هندي فلسفه	Philosophie indienne
دليپ کمار	Dilip Kumar
سونيل دت	Sunil Dutt
د ايران هوايي ځواک	Force aérienne de la République islamique d'Iran
دهرمندر	Dharmendra
ملا دادالله اخوند	Dadullah
لوييس سلوتين	Louis Slotin
شاهد اپریدی	Shahid Afridi
آر کیو - ۱۱ ړاوېن	RQ-11 Raven
ال-۱۵۹ الکا	Aero L-159 Alca
ابراهيم لودي	Ibrahim Lodi
ولاديمير الېکساندروويچ کريوچکوف	Vladimir Krioutchkov
لمن لگښت	Coût marginal
افغان ملي پوځ	Armée nationale afghane
د افغانستان د فوټبال فدراسيون	Fédération d'Afghanistan de football
کارلوی واری	Karlovy Vary
اپريدي	Afridi (pachtounes)
خاد	KHAD
اهل بيت	Ahl al-Bayt
خوست	Khost
آفتاب احمد خان شېرپاو	Aftab Ahmad Sherpao
سوات ولسوالۍ	District de Swat
د هخامنشیانو ټولواکمني	Achéménides
شکودا ټي – ۱۵	Škoda 15 T
شکودا سوپرب	Škoda Superb
شاه ولي الله	Shah Waliullah ad-Dehlawi
مهدي حسن	Mehdi Hassan
معیاري ژبه	Langue standard
سايکلوفوسفمايډ	Cyclophosphamide
ایندومټاسین	Indométacine
سپېرکۍ	Ajowan
اېنالاپريل	Énalapril
سپيرونولکټون	Spironolactone
مېبېندازول	Mébendazole
هېموسېدرين	Hémosidérine
اوکټوجن	HMX
اوميپرازول	Oméprazole
بودېسونايد	Budésonide
فېنواکسيمېتيل پېنيسيلين	Phénoxyméthylpénicilline
کلوکساسيلين	Cloxacilline
ديجوکسين	Digoxine
ډاپسون	Dapsone
ډيلټيازيم	Diltiazem
مېټوټرکسات	Méthotrexate
دوكسيسايكلين	Doxycycline
جنټامايسين	Gentamicine
لوپيناوير	Lopinavir
امټريسيټابين	Emtricitabine
ډيډانوسين	Didanosine
ريټوناوير	Ritonavir
لاميووډين	Lamivudine
ساکويناوير	Saquinavir
رانيتيدين	Ranitidine
نېلفيناوير	Nelfinavir
سټاووډين	Stavudine
وانکومايسين	Vancomycine
سالمېټېرول	Salmétérol
الاقصی جومات	Mosquée al-Aqsa
انډيناوير	Indinavir
د افغانستان اسلامي امارت	Émirat islamique d'Afghanistan
مسجد الحرام	Masjid al-Haram
الخالد شوبله	Al-Khalid
منبر	Minbar
ولادېمير افاناسېويچ لياخوف	Vladimir Liakhov (cosmonaute)
اسلامي بانکوالی	Finance islamique
شاه شجاع	Shah Shuja
سوخوی سو ٣٧	Soukhoï Su-37
حبيبه سهرابي	Habiba Sarobi
کرېشما کپور	Karisma Kapoor
ملکه رضيه	Sultan Razia
رېکها	Rekha
شرميلا تاگور	Sharmila Tagore
حميرا بېگم	Homeira
مينا کماري	Meena Kumari
شبانه اعظمي	Shabana Azmi
حميده برمکي	Hamida Barmaki
مينا کشور کمال	Meena Keshwar Kamal
ديا مرزا	Diya Mirza
آلماني چابکۍ	Blatte germanique
لخدر ابراهيمي	Lakhdar Brahimi
فرېدرېک بارټ	Fredrik Barth
غياث الدين کيخسرو بن کيقباد	Kay Khusraw II
هنري کوربان	Henry Corbin
مظفر الدين شاه قاجار	Mozaffaredin Shah
جهان آرا بېگم	Jahanara
د درانيانو ټولواکمني	Empire Durrani
گردېز	Gardêz
ملټيپل ميولوما	Myélome multiple
بوينگ بي ۴۷ سټراټوجېټ	Boeing B-47 Stratojet
اسکاريس لومبريکويډېس	Ascaris (parasite)
سونو نېگم	Sonu Nigam
ابن زهر	Avenzoar
امير عنايت الله خان	Inayatullah Shah
ويليم مونټگمري وات	William Montgomery Watt
حبيب الله کلکاني	Habibullah Ghazi
لومړۍ خور	Rabia al awal
لښکرگاه	Lashkar Gah
تالقان	Tâloqân
دوشکا (د الوتکو ويشتونکي ماشيندار)	DShK
بيشاپور	Bishapour
ابن مسكويه	Miskawayh
شريعت	Charia
اوزبکان	Ouzbeks
ازمېښتون	Laboratoire de recherche
جيروسكوپ	Gyroscope
تاجکيان	Tadjiks
سني اسلام	Sunnisme
آزربايجاني منات	Manat azerbaïdjanais
بې پيلوټه الوتکه	Drone
محمد اقبال	Mohamed Iqbal
فقه	Jurisprudence islamique
چنگېز ايتمانوف	Tchinguiz Aïtmatov
مۍ	Haricot mungo
د باميانو بودايي پژۍ	Bouddhas de Bâmiyân
تورکمنان	Turkmènes
نړیوال سازمان	Organisation internationale
د ژبې فلسفه	Philosophie du langage
شانگهای د همکاريو سازمان	Organisation de coopération de Shanghai
کلبيان	Cynisme
د آزادۍ راډيو	Radio Free Europe
اورنگزیب عالمگیر	Aurangzeb
راني موکېرجي	Rani Mukherjee
مسجد نبوي	Masjid al-Nabawi
اسلاموفوبيا	Islamophobie
ازبکستاني سوم	Sum (monnaie)
صفره	Safar
ابن تيميه	Ibn Taymiyya
د سجیل توغندی	Sejil
د نور توغندۍ	Noor (missile)
ماتريديه	Maturidisme
بولندوی	Lieutenant-colonel
د افغانستان ولسوالۍ	District d'Afghanistan
مېټامتريال	Métamatériau
الوتکه (فلم)	Y a-t-il un pilote dans l'avion ?
توبه	Repentance
ختيځي کيکه	Xenopsylla cheopis
اسد الله خالد	Asadullah Khalid
د شاه فیصل جومات	Mosquée Faisal
د اوبو ښاپېرک	Myotis daubentonii
نېفروټېک ساينډروم	Syndrome néphrotique
ادريس شاه	Idries Shah
انځور خبريالي	Photojournalisme
د افغانستان د لارښودانو لړليک	Liste des chefs d'État d'Afghanistan
هډه	Hadda
سنتره	Tangerine
نخاعي شريان	Artère vertébrale
تومانچه مادل ۵۲	CZ 52
هريپور (پاکستان)	Haripur (Pakistan)
د الماني ژبې گرامر	Grammaire allemande
ISO 22000	ISO 22000
صلی الله عليه وسلم	Formule d'eulogie en islam
اشاعره	Asharisme
ټريپانوسوما	Trypanosoma
د ميوند جگړه	Bataille de Maiwand
ماشین گڼ ماډل ۵۹	Vz. 59
پېښور ولسوالۍ	District de Peshawar
څاڅکي	Collyre
توريالی وېسا	Tooryalai Wesa
خواجه عبدالله انصاري	Khawâdjâ Abdallâh Ansârî
پريتويراج چوهان	Prithivîrâja Châhumâna III
سمېع يوسف	Sami Yusuf
محمد شاه قاجار	Mohammad Shah Qajar
ميرويس هوتک	Mirwais Khan Hotak
مقبول فدا حسین	Maqbool Fida Husain
محمد عالم خان	Alim Khan
شاه اشرف هوتک	Ashraf (Ghilzai)
ډانگ لکۍ	Tchitrec de paradis
پروټينيوريا	Protéinurie
بوللـه	Qasida
رضوي خراسان ولايت	Khorasan-e Razavi
بفر سټېټ	État tampon
کونډه	Mousqueton
تومانچه مادل ٧٥	CZ 75
سپين بولدک	Spin Boldak
سکن ایگل	Boeing ScanEagle
جعفر اباد ولسوالۍ	District de Jafarabad
څارنوال	Procureur
ټرانس امينېشن	Transamination
گلومېرولونېفرايټس	Glomérulonéphrite
د پاني پت لومړۍ جگړه	Première bataille de Panipat
بوکان	Bukan
آنتونوف-۱۴۸	Antonov An-148
کلات ولسوالۍ (بلوچستان)	District de Kalat
ابهيدا	Abhidhamma
امير ډنډ	Band-e Amir
امير محمد يعقوب خان	Mohammad Ya'qub Khan
ټوپولف ټو-۳۳۴	Tupolev Tu-334
ډئيزم	Déisme
دگماتېزم	Dogme
گلسر	Serin à front d'or
اوبدرملنه	Hydrothérapie
برېښنامېچ	Compteur électrique
ښځه په اسلام کې	Rapport entre hommes et femmes dans l'islam
ملي گټې	Raison d'État
د هوتکيانو ټولواکمني	Hotaki
جان گرين	John Green (écrivain)
عبدالحق	Abdul Haq
د تودوخې د لېږد وړتیا	Coefficient de transfert thermique
سامويل الېکسانډر کينير وېلسن	Samuel Alexander Kinnier Wilson
اسلامي تاريخ	Histoire de l'islam
امام جومات	Mosquée du Chah
کتيتر	Cathéter
آريانا افغان هوايي شرکت	Ariana Afghan Airlines
آريانا تلويزيون	Ariana Television Network
د چېک د جمهوریت هوایي ځواک	Force aérienne tchèque
سوداگري (فلم)	Trade
معتزله	Mutazilisme
شهاب ۳	Shahab-3
اسحاق	Isaac
بانکي گڼون	Types de dépôts bancaires
د کوچني اختر مياشت	Chawwal
اسد آباد	Assadâbâd
ويکيپېډيا:ډ-ځ-پ/ښوونځي	Aide:FAQ/enseignement
زو – ۲۳ – ۲	ZU-23-2
د بون تړون	Accords de Bonn (Afghanistan)
ټاټرا ۸۱۵	Tatra T815
اېف ۱ لاسي بم	Grenade F1 (Russie)
ټاټرا ۸۱۳	Tatra T813
د افغانستان ملي لرغونتون	Musée national afghan de Kaboul
د اشراق فلسفه	Illuminisme
عينک د تامبې کان	Mes Aynak
درملپېژندنه	Pharmacodynamique
ريگويدا	Rig-Véda
کوهستان ولسوالۍ (پښتونخوا)	District du Kohistan
تارو	Perdrix
شاه محمود سدوزى	Mahmud Shâh Durrani
طيبه لښکر	Lashkar-e-Toiba
سيد محمد حسين طباطبايي	Ayatollah Sayyid Muhammad Husayn Tabataba'i
نورستانيان	Nouristani
لاله سری	Faucon chicquera
چنجری	Francolinus
محمد حسين سراهنگ	Mohammad Hussain Sarāhang
نجراب ولسوالۍ	Nijrab (district)
د غشی زهر آبي چونگښه	Dendrobates azureus
جي اېف ۱۷ تهنډر	JF-17 Thunder
حامد کرزی نړيوال هوايي ډگر	Aéroport international de Kaboul
وزلوبه	Bouzkachi
آية الکرسي	Verset du Trône
تپندۍ	Truelle
معمولي وامبټ	Vombatus ursinus
هېلېنيستي فلسفه	Philosophie hellénistique
کورکورۍ	Ganga cata
تور-ام۱	9K330 Tor-M1
ملاله ميوندواله	Malalai Anaa
بوټځمکپوهنه	Phytogéographie
امام حسين جومات	Mosquée de l'imam Hussein
لېیوروس قوینقوېستریاتوس	Leiurus quinquestriatus
د روژومبرک کلا	Château de Rožmberk
د افغانستان ملي راډيو تلويزون	Radio Television Afghanistan
ساييز غږونه	Auscultation pulmonaire
تجويد	Tajwid
پنجوايي ولسوالۍ	Panjwai
ملتون	Compagnie (entreprise)
اسلامي ساينس	Sciences arabes
ظهير الدين محمد بابر	Babur
ډيلوکسنايډ فورواېټ	Furoate de diloxanide
پاکستان مسلم لیگ ن	Ligue musulmane du Pakistan (N)
ږيره ور خوگ	Sus barbatus
درېيځ (مېچپوهنه)	Cube
آتريال فېبرېلېشن	Fibrillation atriale
هډپوهنه	Ostéologie
څلورمه خور	Joumada ath-thania
ارواپالنه	Spiritualisme moderne anglo-saxon
چاپېريال ساتنه	Protection de l'environnement
ماشيندار مادل ٦١	Skorpion VZ61
جنت	Jannah
فيزيکي کتنه	Examen clinique
يهودي فلسفه	Philosophie juive
اومان	Ephedrales
امام علي آرام ځاي	Mosquée de l'imam Ali
ټاټرا ټې – ۳	Tatra T3
لوېديځه فلسفه	Philosophie occidentale
مندر	Mandir
لويه جرگه	Loya Jirga
اسلامي زده کړې	Sciences islamiques
رقم جوړؤنکي وسایل	Numérisation
آئیسو 639-3	ISO 639-3
د زړه عضلاتي اعتلال	Cardiomyopathie
نيوروفېبروماټوسېز	Neurofibromatose
درېيمه خور	Joumada al oula
ټوپک مادل ٥٨	Sa Vz 58
کومييز سرطان	Cancer du larynx
پېرودونکی	Client (économie)
تېزپر	Glaréole
د استخباراتو امنيتي اداره	Bezpečnostní informační služba
عيسوي فلسفه	Philosophie chrétienne
دوه څنډی	Digone
تورړۍ	Traquet rieur
د سږو بوغمه	Œdème aigu du poumon
آی خانم	Aï Khanoum
وییزېرمه	Glossaire
معاصره فلسفه	Philosophie moderne
د ناروغيو لړليک	Liste de maladies
يوناني درمل	Herboristerie
د مهدي پوځ	Armée du Mahdi
پاکستان مسلم لیگ ق	Ligue musulmane du Pakistan (Q)
د اکولا اوبتل	Classe Akoula
چترال ولسوالۍ	District de Chitral
دارالامان ماڼۍ	Palais de Darulaman
توردلی	Saxicola
د رېږدلې انجنيري	Génie parasismique
ماليکولي ننوونی	Tamis moléculaire
مونټ سټوارټ الفنسټن	Mountstuart Elphinstone
برېښنایي مرمري سکيټ کب	Torpille marbrée
تور نس لرونکي ستن	Orthetrum cancellatum
هېماټوپويسز	Hématopoïèse
هندو (ورځپاڼه)	The Hindu
گجرات	Gujrat
ذاکر نايک	Zakir Naik
اسلامي وييپانگه	Vocabulaire de l'islam
ميدان ښار ولسوالۍ	Maydan Shahr
جهنگ ولسوالۍ	District de Jhang
د سيستان او بلوچستان ولايت	Sistan-et-Balouchistan
اورشلیمی کنيسه	Synagogue jubilaire
ټټر	Thorax (anatomie des insectes)
سني ډيول	Sunny Deol
ايراني هڅوب	Culture de l'Iran
بژېونوف صومعه	Monastère de Břevnov
دولت آباد ولسوالۍ	Daoulatabad
سپين باز	Buse blanche
ستراهوف صومعه	Monastère de Strahov
محمد اسلم وطنجار	Mohammed Aslam Watanjar
افغانايټ	Afghanite
هندو خدايان	Divinités du Sanatana Dharma
سلطان علي کشتمند	Sultan Ali Keshtmand
سونيل شيټي	Sunil Shetty
سردار نصرالله خان	Nasrullah Khan
سهېل خان	Sohail Khan
د افغانستان د تاريخ پېښليک	Chronologie de l'Afghanistan
اېکزېما	Eczéma (syndrome)
د افغان-انگرېز لومړۍ جگړه	Première guerre anglo-afghane
مردان	Mardan
لرغونې يوناني فلسفه	Philosophie en Grèce antique
بودايي فلسفه	Philosophie bouddhiste
يشناټکی	Point d'ébullition
د فارس ولايت	Fars
د تاج ښیښه	Soufflage en couronne
د نړۍ برحاله هېوادمشران	Liste des dirigeants actuels des États
مستونگ ولسوالۍ	District de Mastung
پاړاچنار	Parachinar
انار دره ولسوالۍ	Anâr Darreh (district)
هالي بېري	Halle Berry
خنجان ولسوالۍ	Khinjan (district)
غبرگه ښیښه	Double vitrage
د روسيې دولتي کتابتون	Bibliothèque d'État de Russie
ابو الفتح الشهرستاني	Muhammad al-Shahrastani
د بوټي ژونکه	Cellule végétale
د استخباراتو پرانيستى سرچينه	Renseignement d'origine source ouverte
اږبکه	Hirondelle noire
اسيا پېسفيک	Asie-Pacifique
ووبرنځپوهنه	Histopathologie
يوڅنډی	Hénagone
د لوگر ولايت د بيارغونې ډله	Équipe provinciale de reconstruction
پېښور	Peshawar
کرک ولسوالۍ	District de Karak
آر پي جي – ۲۹	RPG-29
څېړنيزه خبريالي	Journalisme d'enquête
جرمنۍ غومبسه	Guêpe germanique
زهوب	Exsudat
اوندن برونشيت	Bronchite chronique
حدود	Hudud
د افغانستان ولسمشر	Liste des présidents de l'Afghanistan
فرعوني مېږی	Fourmi pharaon
طلا تپه	Tillia tepe
د مخترعینو لړليک	Liste d'inventeurs
اداينه	Moyen de paiement
د افغانستان حکومت	Politique en Afghanistan
د افغانستان بانک	Da Afghanistan Bank
خروشتي	Alphabet kharosthi
جرگه	Jirga
خدايگوټی	Yazata
ډومبک	Saxicolinae
اپولینارېزم	Apollinarisme
د بابر توغندی	Hatf 7
دوتنه	File
لافايټ جنگي بېړۍ	Classe La Fayette
ناپروکسين	Naproxène
شکوڼ	Porc-épic
ويکيپېډيا:نړيواله غږيزه ابېڅې	Aide:Alphabet phonétique international
نوی اتلانتېس	La Nouvelle Atlantide
تعبیه شوی چاودیدونکی وسیله	Engin explosif improvisé
کوهاټ ولسوالۍ	District de Kohat
د پاني پت دريمه جگړه	Troisième bataille de Panipat
د افغان-انگرېز درېمه جگړه	Troisième guerre anglo-afghane
رسم	Rasm
تورغاړي ـ اوږدمښوکي مارغه	Colibri à ventre noir
بېړۍ ژرنده	Moulin flottant
سولگریز جال	Réseau informatique
ځنگلي خزدکه	Anoplotrupes stercorosus
افغان پيکا	Pika afghan
پر اسلام نيوکه	Critique de l'islam
قارون	Coré (Bible)
اسلامي هڅوب	Culture islamique
توره بوړه	Tora Bora
اسلامي وټه	Doctrine économique islamique
کابل پوهنتون	Université de Kaboul
موسکيټ	P-270 Moskit
د کاربن ډای اکسایډ ليزر	Laser au dioxyde de carbone
د اصفهان ولايت	Province d'Ispahan
ويکيپېډيا:وييپانگه	Aide:Jargon de Wikipédia
مرتضی مطهري	Morteza Motahhari
تگاب ولسوالۍ (کاپيسا)	Tagab (district)
وېليم حې مېکناټن	William Hay Macnaghten
وېشنيزه:د امريکا متحده ايالات	Catégorie:États-Unis
وېشنيزه:روسيه	Catégorie:Russie
وېشنيزه:کاناډا	Catégorie:Canada
وېشنيزه:برطانيه	Catégorie:Royaume-Uni
وېشنيزه:چين	Catégorie:Chine
وېشنيزه:هندوستان	Catégorie:Inde
وېشنيزه:سعودي عربستان	Catégorie:Arabie saoudite
وېشنيزه:ايران	Catégorie:Iran
پښتونولي	Pachtounwali
هانډلې پېج ټايپ او	Handley Page Type O
لامبوځنه ښیښه	Verre plat
ابدالي	Durrani
د مقدس جورج کلیسا	Basilique Saint-Georges de Prague
وېشنيزه:افغانستان	Catégorie:Afghanistan
وېشنيزه:الجېريا	Catégorie:Algérie
وېشنيزه:عراق	Catégorie:Irak
وېشنيزه:نېدرلانډ/هالېنډ	Catégorie:Pays-Bas
وېشنيزه:نايجېريا	Catégorie:Nigeria
وېشنيزه:پاکستان	Catégorie:Pakistan
وېشنيزه:د روم امپراطوری	Catégorie:Empire romain
وېشنيزه:مارغان	Catégorie:Oiseau
وېشنيزه:بوټي	Catégorie:Plante
وېشنيزه:ژونپوهنه	Catégorie:Biologie
وېشنيزه:پېښليک	Catégorie:Histoire
وېشنيزه:ځمکپوهنه	Catégorie:Géographie
وېشنيزه:ټولنه	Catégorie:Société
وېشنيزه:مذهب	Catégorie:Religion
وېشنيزه:ورزښت	Catégorie:Sport
وېشنيزه:اروپايي اتحاديه	Catégorie:Union européenne
وېشنيزه:ټوليزې رسنۍ	Catégorie:Médias
وېشنيزه:ژبه	Catégorie:Langage
وېشنيزه:ځمکه	Catégorie:Terre
وېشنيزه:تشيال	Catégorie:Espace
مړاپ زره پوښ گاډي	MRAP (véhicule)
ټېمېلين اټومي برېښناکوټ	Centrale nucléaire de Temelín
طلوع تلويزيون	Tolo TV
بر دير ولسوالۍ	District d'Upper Dir
د بشري حقونو نړېواله اسلامي اعلاميه	Déclaration des droits de l'homme en islam
د الضرار ټانک	Al-Zarrar
خواږه مرچ	Poivron
نوښار ولسوالۍ	District de Nowshera
Henriette Confurius	Henriette Confurius
د پاکستان هوايي ځواک	Force aérienne pakistanaise
رباب	Rubab (instrument)
شهاب الدين محمد غوري	Muhammad Ghûrî
سرپل	Sar-é Pol (ville)
څېړونکی	Chercheur
مصطفى سباعي	Moustapha Siba’i
له پلوما	La Paloma (chanson)
اورمکۍ	Hétérocères
ابراهيم	Ibrahim
نړيواله ټولنه	Communauté internationale
ملهم	Pommade
کاربون نانو نل	Nanotube de carbone
محصول	Produit
بکوا ولسوالۍ	Bakwa (district)
د افغانستان هوايي ځواک	Force aérienne afghane
رکوع	Ruku
حاد برونشيت	Bronchite aiguë
ارغنداب ولسوالۍ (کندهار)	Arghandab (district)
خبريال	Journaliste
سوده بنت زمعه	Sawda bint Zama
کيشکره	Nucifraga
د حسن او حسين مياشت	Mouharram
د افغانستان وټه	Économie de l'Afghanistan
وېشنيزه:فلسفه	Catégorie:Philosophie
وېشنيزه:عيسويت	Catégorie:Christianisme
وېشنيزه:اسلام	Catégorie:Islam
وېشنيزه:يهوديت	Catégorie:Judaïsme
پارت	Parthes
جزء	Juz'
اخوان الصفا	Ikhwan al-Safa
ويکيپېډيا:د پټنتيا تګلاره	Politique de confidentialité
سروبي ولسوالۍ	District de Saroubi
ملا صدرا	Molla Sadra Shirazi
خمس	Khoms (impôt)
توپک مادل ۲۴	Mauser-CZ
لکي مروت ولسوالۍ	District de Lakki Marwat
بونير ولسوالۍ	District de Buner
شريا گوشل	Shreya Ghoshal
رهبانيت	Ordre religieux
گوادر ولسوالۍ	District de Gwadar
اميرالمومنين	Commandeur des croyants
گوربت	Aigle
په اسلام کې د خدای تصور	Dieu (islam)
چسکی کروملوف (ماڼۍ)	Château de Český Krumlov
سلطان معزالدين کيقباد	Muizz ud-Dîn Kaiqûbâd
اسلام شاه سوري	Islam Shah Suri
چرگه	Poule
چرگ	Coq
سراج الدين حقاني	Seraj Haqqani
ساتنه	Protection
وړانگه	Ray
مولتان ولسوالۍ	District de Multan
پشين ولسوالۍ	District de Pishin
فيصل آباد ولسوالۍ	District de Faisalabad
حافظ آباد ولسوالۍ	District d'Hafizabad
گوجرانواله ولسوالۍ	District de Gujranwala
بهاولپور ولسوالۍ	District de Bahawalpur
لوره لايي ولسوالۍ	District de Loralai
بولان ولسوالۍ	District de Kachhi
ژوب ولسوالۍ	District de Zhob
اټک ولسوالۍ	District d'Attock
ایلیا ابو ماضي	Elia Abu Madi
زيارت ولسوالۍ	District de Ziarat
نصير اباد ولسوالۍ	District de Nasirabad
دېره غازي خان ولسوالۍ	District de Dera Ghazi Khan
موسی خېل ولسوالۍ (بلوچستان)	District de Musakhel
چکوال ولسوالۍ	District de Chakwal
بهکر ولسوالۍ	District de Bhakkar
کوټه ولسوالۍ	District de Quetta
ډېره بگټي ولسوالۍ	District de Dera Bugti
سيالکوټ ولسوالۍ	District de Sialkot
کوهلو ولسوالۍ	District de Kohlu
کهمرد ولسوالۍ	Kahmard (district)
خراسان	Grand Khorasan
لر دير ولسوالۍ	District de Lower Dir
مانسهره ولسوالۍ	District de Mansehra
سيد بهاو الدين مجروح	Sayd Bahodine Majrouh
اندراب ولسوالۍ	Andarab (district)
مردان ولسوالۍ	District de Mardan
د پاکستان ولسوالۍ	Districts du Pakistan
چارسده ولسوالۍ	District de Charsadda
هنگو ولسوالۍ	District de Hangu (Pakistan)
شنگله ولسوالۍ	District de Shangla
بالا بلوک ولسوالۍ	Bala Buluk (district)
بوښوتنيکا	Bochotnica
الاسمای	Al-Asmai
فراه ولسوالۍ	Farâh (district)
شېراني ولسوالۍ	District de Sherani
قيف غاښ لرونکي ژوي	Yanoconodon
ساهيوال ولسوالۍ	District de Sahiwal
راجنپور ولسوالۍ	District de Rajanpur
ويهاړي ولسوالۍ	District de Vehari
ليه ولسوالۍ	District de Layyah
نارووال ولسوالۍ	District de Narowal
منډي بهاوالدين ولسوالۍ	District de Mandi Bahauddin
ميانوالي ولسوالۍ	District de Mianwali
تولید (سوداگري)	Politique de produit
نوشکي ولسوالۍ	District de Nushki
پنجگور ولسوالۍ	District de Panjgur
د عراق او شام اسلامي دولت	État islamique (organisation)
لښکرگاه ولسوالۍ	Lashkargâh
يونس	Jonas
وټيز څېړندود	Méthodologie économique
د افغانستان ژبې	Langues en Afghanistan
داستان	Dâstân
سبي ولسوالۍ	District de Sibi
بادخورک	Crécerelle (oiseau)
د فيلسوفانو لړليک	Liste de philosophes par année de naissance
لودهران ولسوالۍ	District de Lodhran
ننکانه صاحب ولسوالۍ	District de Nankana Sahib
چنيوټ ولسوالۍ	District de Chiniot
شېخپوره ولسوالۍ	District de Shekhupura
قصور ولسوالۍ	District de Kasur
ویدانتا	Védanta
شېب کوه ولسوالۍ	Shib Koh (district)
گلستان ولسوالۍ	Gulistan (district)
پر چمن ولسوالۍ	Pur Chaman
پشت رود ولسوالۍ	Push e Rod (district)
لاش او جواين ولسوالۍ	Lash wa Juwayn (district)
د افغانستان بنسټيزه کړنلاره	Constitution de l'Afghanistan
پښتانه	Pachtounes
لکي مروت	Lakki Marwat
سکندر لودي	Sikandar Lodi
لیس ډوسېټ	Lyse Doucet
ابو الفضل محمد بيهقي	Abolfazl Beyhaghi
خوشاب ولسوالۍ	District de Khushab
مرزا اسلم بېگ	Mirza Aslam Beg
د افغانستان د اوسنيو واليانو لړليک	Liste des gouverneurs des provinces afghanes
جهل مگسي ولسوالۍ	District de Jhal Magsi
افغانان (آسټراليا)	Afghans (Australie)
رحيميار خان ولسوالۍ	District de Rahim Yar Khan
خضدار ولسوالۍ	District de Khuzdar
گرېگ مورټنسن	Greg Mortenson
ميوند ولسوالۍ	Maywand (district)
شاه ولي کوټ ولسوالۍ	Shah Wali Kot
خاکرېز ولسوالۍ	Khakrez (district)
خواهان ولسوالۍ	Khwahan (district)
کندهار ولسوالۍ	Kandahâr (district)
نېش ولسوالۍ	Naish (district)
تخنيک	Technique
خاک سفېد ولسوالۍ	Khak e Safid (district)
قلعه کاه ولسوالۍ	Qala i Kah (district)
چامبېلي	Jasminum grandiflorum
پراناف مېستري	Pranav Mistry
تهافت الفلاسفه	Tahafut al-Falasifa
ديا خان	Deeyah Khan
بهلول لودي	Bahlul Lodi
خوست او فرنگ ولسوالۍ	Khost wa Fereng (district)
نكاح	Droit du mariage dans la tradition musulmane
رسنۍ	Théorème de la moyenne
عبدالصمد روحاني	Abdul Samad Rohani
آلاسای ولسوالۍ	Alasay (district)
آينه تلويزيون	Ayna TV
حسن بک جومات	Mosquée Hassan Bek
سمبالښت	Management
باک ولسوالۍ	Bäk (district)
ننداره	Show
وېشنيزه:هڅوب	Catégorie:Culture
وېشنيزه:لويې وچې	Catégorie:Continent
وېشنيزه:ځمکپېژنده	Catégorie:Géologie
وېشنيزه:الوتکې	Catégorie:Type d'aéronef
چنای ایکسپریس	Chennai Express
هرنۍ ولسوالۍ	District de Harnai
جام جم	Coupe de Jamshid
ژونکپوهنه	Cytologie
دامان ولسوالۍ	Daman (district)
بنو ولسوالۍ	District de Bannu
محمود راقي ولسوالۍ	Mahmoud Râqi
حاجي زمان	Zaman Ghamsharik
فيض محمد کاتب هزاره	Faiz Mohammed Hazâra
فتحي يکن	Fathi Yakan
چتکی	Fauvette
پژواک خبري اژانس	Agence Pajhwok
واټ بړاس ماشين	Machine de Watt
نانسي دوپري	Nancy Dupree
ممتاز	Mumtaz (actrice)
میثاق کاظمي	Mithaq Kazimi
اورياخېل	Oriakhill
باغبان (فلم)	Baghban
حصه اول کوهستان ولسوالۍ	Hesa Duwum Kohistan
هدايت امين ارسلا	Hedayat Amine Arsala
وېليم برايډن	William Brydon
هېواد	Pays (aménagement du territoire)
ايشوبی	Chaudière
غوړگه	Mollet
بټگرام ولسوالۍ	District de Battagram
هنرونه	Arts
مالاکنډ ولسوالۍ	District de Malakand
تانبه:ځمکپوهنه	Portail:Géographie
تانبه:فلسفه	Portail:Philosophie
د کوکا کولا شرکت	The Coca-Cola Company
ميمونه بنت الحارث	Maymouna bint al-Harith
نازيه اقبال	Nazia Iqbal
د شکیانو ښوونځې	Nouvelle Académie
انساني کوپړۍ	Tête (anatomie humaine)
ببی	Bécassine (oiseau)
واصل بن عطا	Wassil Ibn Ata
صوفی محمد	Soofi Mohammed
ترتيل	Tartil
کيمياوي وسلې	Arme chimique
وېشنيزه:د پوهنغونډ روباټان	Catégorie:Bot Wikipédia
عنزه	Anza (missile)
وېشنيزه:د افغانستان توکمونه	Catégorie:Groupe ethnique d'Afghanistan
تانبه:ټولنه	Portail:Société
خوبانۍ	Abricot
د کندهار پوهنتون	Université de Kandahār
بخت خان	Bakht Khan
بشري حقونه په افغانستان کې	Droits de l'homme en Afghanistan
تانبه:هنرونه	Portail:Arts
احمد شاه خان	Ahmad Shah Zaher
د پېښور پوهنتون	Université de Peshawar
کينډۍ:دوراشې کامه	Modèle:Citation
وېشنيزه:هېوادونه	Catégorie:Pays
وېشنيزه:وټپوهنه	Catégorie:Économie
ويکيپېډيا:پازوالان	Wikipédia:Administrateur
ويکيپېډيا:روباټان	Wikipédia:Bot
وېشنيزه:وخت	Catégorie:Temps
وېشنيزه:انټرنټ	Catégorie:Internet
وېشنيزه:بوټپوهنه	Catégorie:Botanique
وېشنيزه:اناتومي	Catégorie:Anatomie
وېشنيزه:طب	Catégorie:Médecine
وېشنيزه:سياست	Catégorie:Politique
گڼنه	Comptabilité d'entreprise
مصر	Égypte
اسلامي نظام	État islamique
وېشنيزه:فيلسوفان	Catégorie:Philosophe
کينډۍ:Bot	Modèle:Bot
کاناډا	Canada
وېشنيزه:هنګري	Catégorie:Hongrie
وېشنيزه:د اروپایي اتحادیې غړي هیوادونه	Catégorie:État membre de l'Union européenne
وېشنيزه:چېک جمهوريت	Catégorie:République tchèque
وېشنيزه:سلواکيا	Catégorie:Slovaquie
ويکيپېډيا:نيوليک	Aide:Consultation
اکدي واکمنۍ	Empire d'Akkad
وېشنيزه:مايکروسافټ	Catégorie:Microsoft
تانبه:پوهنه	Portail:Sciences
کينډۍ:Flagicon	Modèle:Drapeau
وېشنيزه:د اروپا هېوادونه	Catégorie:Pays d'Europe
وېشنيزه:اروپا	Catégorie:Europe
تانبه:تازه پېښې	Portail:Actualité
کينډۍ:لاسوند	Modèle:Documentation
ويکيپېډيا:د ټولنې تانبه	Wikipédia:Accueil de la communauté
وېشنيزه:User languages	Catégorie:Wikipédiens par langue
ويکيپېډيا:کارن-نوم	Wikipédia:Nom d'utilisateur
عايشه بنت ابي بکر	Aïcha
ارگ	Palais présidentiel de Kaboul
سوداگري	Entreprise
تانبه:ټکنالوجي	Portail:Technologies
کينډۍ:Softredirect	Modèle:Redirection douce
کينډۍ:ړنگول	Modèle:Suppression Immédiate
ليکبڼه	Fonte de caractères
وېشنيزه:ژبې	Catégorie:Langue
ويکيپېډيا:General disclaimer	Wikipédia:Avertissements généraux
کينډۍ:Navbox	Modèle:Méta palette de navigation
ويکيپېډيا:Shortcut	Modèle:Raccourci
وېشنيزه:د ایران ښارونه	Catégorie:Ville d'Iran
خيميران	Chimaeriformes
کينډۍ:Citation needed	Modèle:Citation nécessaire
بينگړۍ	Courge
تانبه:ژوندليکونه	Portail:Biographie
کينډۍ:!	Modèle:!
کينډۍ:Tnavbar	Modèle:Tnavbar
ايمان	Foi
کينډۍ:Clear	Modèle:Clr
کينډۍ:Col-begin	Modèle:Col-début
کينډۍ:Col-end	Modèle:Col-fin
کينډۍ:Anchor	Modèle:Ancre
کينډۍ:Babel	Modèle:Boîte Babel
کينډۍ:Commons	Modèle:Commons
کينډۍ:لړسرچينې	Modèle:Références
کينډۍ:AFG	Modèle:Afghanistan
کينډۍ:نابشپړ	Modèle:Ébauche
کينډۍ:User de	Modèle:Utilisateur de
کينډۍ:User en-3	Modèle:Utilisateur en-3
کينډۍ:User en-1	Modèle:Utilisateur en-1
کينډۍ:User en-2	Modèle:Utilisateur en-2
کينډۍ:User en	Modèle:Utilisateur en
کينډۍ:User fa	Modèle:Utilisateur fa
وېشنيزه:افغاني هڅوب	Catégorie:Culture en Afghanistan
کينډۍ:User ja	Modèle:Utilisateur ja
کينډۍ:User ja-1	Modèle:Utilisateur ja-1
وېشنيزه:امريکايي لرغونپوهان	Catégorie:Archéologue américain
کينډۍ:د هېواد مالومات تاجکستان	Modèle:Country data Tadjikistan
وېشنيزه:آسيا	Catégorie:Asie
کينډۍ:د هېواد مالومات کویټ	Modèle:Country data Koweït
کينډۍ:Mod	Modèle:Mod
کينډۍ:ISO639-3Documentation	Modèle:Lien ISO 639-3
کينډۍ:د هېواد مالومات بلجيم	Modèle:Country data Belgique
کينډۍ:د هېواد مالومات سلواکيا	Modèle:Country data Slovaquie
کينډۍ:د هېواد مالومات اېل سلوادور	Modèle:Country data Salvador
کينډۍ:د هېواد مالومات پاناما	Modèle:Country data Panama
کينډۍ:د هېواد مالومات اېکوادور	Modèle:Country data Équateur
کينډۍ:د هېواد مالومات اېتوپيا	Modèle:Country data Éthiopie
کينډۍ:د هېواد مالومات تونېسيا	Modèle:Country data Tunisie
کينډۍ:د هېواد مالومات د چېک جمهوريت	Modèle:Country data République tchèque
کينډۍ:د هېواد مالومات تايلنډ	Modèle:Country data Thaïlande
کينډۍ:د هېواد مالومات کيوبا	Modèle:Country data Cuba
کينډۍ:د هېواد مالومات اندونېزيا	Modèle:Country data Indonésie
کينډۍ:د هېواد مالومات کمبوډيا	Modèle:Country data Cambodge
کينډۍ:د هېواد مالومات سېنېگال	Modèle:Country data Sénégal
کينډۍ:د هېواد مالومات ماداګاسکر	Modèle:Country data Madagascar
کينډۍ:د هېواد مالومات البانيا	Modèle:Country data Albanie
وېشنيزه:درملپوهنه	Catégorie:Pharmacologie
کينډۍ:د هېواد مالومات پېرو	Modèle:Country data Pérou
کينډۍ:د هېواد مالومات پاراګوای	Modèle:Country data Paraguay
کينډۍ:د هېواد مالومات کېنيا	Modèle:Country data Kenya
کينډۍ:د هېواد مالومات نيکاراګوا	Modèle:Country data Nicaragua
کينډۍ:د هېواد مالومات هندوراس	Modèle:Country data Honduras
کينډۍ:د هېواد مالومات ازبکستان	Modèle:Country data Ouzbékistan
کينډۍ:د هېواد مالومات بولېويا	Modèle:Country data Bolivie
کينډۍ:د هېواد مالومات د ډومينيکان جمهوريت	Modèle:Country data République dominicaine
کينډۍ:د هېواد مالومات توگو	Modèle:Country data Togo
کينډۍ:د هېواد مالومات ګواتمالا	Modèle:Country data Guatemala
وېشنيزه:ژبپوهنه	Catégorie:Linguistique
کينډۍ:د هېواد مالومات هايېتي	Modèle:Country data Haïti
کينډۍ:د هېواد مالومات مالي	Modèle:Country data Mali
کينډۍ:د هېواد مالومات لاتويا	Modèle:Country data Lettonie
کينډۍ:د هېواد مالومات مالټا	Modèle:Country data Malte
کينډۍ:د هېواد مالومات ډېنمارک	Modèle:Country data Danemark
کينډۍ:د هېواد مالومات آيسلېنډ	Modèle:Country data Islande
کينډۍ:د هېواد مالومات پولنډ	Modèle:Country data Pologne
کينډۍ:د هېواد مالومات کېپ وردا	Modèle:Country data Cap-Vert
کينډۍ:د هېواد مالومات بلغاريه	Modèle:Country data Bulgarie
کينډۍ:د هېواد مالومات بوسنيا او هېرزگوينا	Modèle:Country data Bosnie-Herzégovine
کينډۍ:د هېواد مالومات ګايانا	Modèle:Country data Guyana
کينډۍ:Wikivar	Modèle:Wikivar
کينډۍ:د هېواد مالومات ناروې	Modèle:Country data Norvège
کينډۍ:د هېواد مالومات سوېلي افريقا	Modèle:Country data Afrique du Sud
کينډۍ:د هېواد مالومات جمايکا	Modèle:Country data Jamaïque
کينډۍ:د هېواد مالومات ګورجستان	Modèle:Country data Géorgie
کينډۍ:د هېواد مالومات ارجنټاين	Modèle:Country data Argentine
کينډۍ:د هېواد مالومات يوروګوای	Modèle:Country data Uruguay
کينډۍ:Country showdata	Modèle:Country showdata
کينډۍ:د هېواد مالومات ټرېنېډاډ او توباګو	Modèle:Country data Trinité-et-Tobago
کينډۍ:د انځور نښه	Modèle:Image label
کينډۍ:د هېواد مالومات برونای	Modèle:Country data Brunei
کينډۍ:د هېواد مالومات سريلانکا	Modèle:Country data Sri Lanka
کينډۍ:د هېواد مالومات مکسيکو	Modèle:Country data Mexique
کينډۍ:د هېواد مالومات یونان	Modèle:Country data Grèce
کينډۍ:د هېواد مالومات لوکسېمبورگ	Modèle:Country data Luxembourg
کينډۍ:د هېواد مالومات سعودي عربستان	Modèle:Country data Arabie saoudite
کينډۍ:د هېواد مالومات بهاماس	Modèle:Country data Bahamas
کينډۍ:د هېواد مالومات کرواتيا	Modèle:Country data Croatie
کينډۍ:د هېواد مالومات عراق	Modèle:Country data Irak
کينډۍ:ليکوال-مالوماتبکس/لاسوند	Modèle:Infobox Écrivain
کينډۍ:د هېواد مالومات متحده عرب امارات	Modèle:Country data Émirats arabes unis
کينډۍ:د هېواد مالومات ماروکو	Modèle:Country data Maroc
کينډۍ:د هېواد مالومات سربيا	Modèle:Country data Serbie
کينډۍ:د هېواد مالومات آسټراليا	Modèle:Country data Australie
کينډۍ:د هېواد مالومات فرانسه	Modèle:Country data France
کينډۍ:Ambox	Modèle:Méta bandeau d'avertissement
کينډۍ:دکارنبکس-بېخ	Modèle:BUfin
کينډۍ:هېواد-مالوماتبکس	Modèle:Infobox Pays
کينډۍ:د هېواد مالومات لاووس	Modèle:Country data Laos
کينډۍ:د هېواد مالومات اتريش	Modèle:Country data Autriche
کينډۍ:د هېواد مالومات نيپال	Modèle:Country data Népal
کينډۍ:ترسره شو	Modèle:Fait
کينډۍ:لاسوند/دلاسوندنوم	Modèle:Documentation/docname
کينډۍ:د هېواد مالومات فېنلاند	Modèle:Country data Finlande
کينډۍ:Audio	Modèle:Prononciation
کينډۍ:د هېواد مالومات مصر	Modèle:Country data Égypte
کينډۍ:د هېواد مالومات لېتوانيا	Modèle:Country data Lituanie
ويکيپېډيا:ځان زده کړه (د ويکيپېډيا تړنې)	Wikipédia:Liens internes
کينډۍ:د هېواد مالومات جاپان	Modèle:Country data Japon
کينډۍ:د هېواد مالومات نېدرلنډ	Modèle:Country data Pays-Bas
کينډۍ:Start box	Modèle:S-start
کينډۍ:ساينسپوه-مالوماتبکس	Modèle:Infobox Scientifique
کينډۍ:پوهنتون مالوماتبکس/لاسوند	Modèle:Infobox Université
کينډۍ:د هېواد مالومات آذربايجان	Modèle:Country data Azerbaïdjan
کينډۍ:د فايرفاکس کارن	Modèle:Utilisateur Firefox
کينډۍ:Ar	Modèle:En arabe
کينډۍ:د هېواد مالومات وېتنام	Modèle:Country data Viêt Nam
کينډۍ:Featured article	Modèle:Article de qualité
کينډۍ:د هېواد مالومات لېبيا	Modèle:Country data Libye
کينډۍ:د هېواد مالومات روسیه	Modèle:Country data Russie
وېشنيزه:User en	Catégorie:Utilisateur en
وېشنيزه:User en-2	Catégorie:Utilisateur en-2
کينډۍ:Navy	Modèle:Marine de guerre
کينډۍ:د هېواد مالومات اېکواټوريال گوينا	Modèle:Country data Guinée équatoriale
کينډۍ:User zh	Modèle:Utilisateur zh
کينډۍ:Colorbox	Modèle:Colorbox
وېشنيزه:دوتر توکي	Catégorie:Matériel de bureau
کينډۍ:د هېواد مالومات اټاليا	Modèle:Country data Italie
کينډۍ:د المان ايالتي نقشه	Modèle:Länder d'Allemagne 2
کينډۍ:User ru-4	Modèle:Utilisateur ru-4
کينډۍ:Pp-template	Modèle:Protection
کينډۍ:د هېواد مالومات سويډن	Modèle:Country data Suède
وېشنيزه:کرهڼه	Catégorie:Agriculture
کينډۍ:User ru	Modèle:Utilisateur ru
کينډۍ:نغا	Modèle:Prononciation API
وېشنيزه:سياستوال	Catégorie:Personnalité politique
وېشنيزه:لمريز نظام	Catégorie:Planète du système solaire
وېشنيزه:امريکا	Catégorie:Amérique
کينډۍ:د هېواد مالومات کوسټاريکا	Modèle:Country data Costa Rica
کينډۍ:د هېواد مالومات هند	Modèle:Country data Inde
کينډۍ:د هېواد مالومات الجېريا	Modèle:Country data Algérie
کينډۍ:د هېواد مالومات وېنېزوېلا	Modèle:Country data Venezuela
کينډۍ:د هېواد مالومات فيجي	Modèle:Country data Fidji
کينډۍ:Infobox Officeholder	Modèle:Infobox Politicien
کينډۍ:د هېواد مالومات انډورا	Modèle:Country data Andorre
کينډۍ:د هېواد مالومات آنگولا	Modèle:Country data Angola
کينډۍ:د هېواد مالومات بوټسوانا	Modèle:Country data Botswana
کينډۍ:د هېواد مالومات اروپايي اتحاديه	Modèle:Country data Union européenne
کينډۍ:Border	Modèle:Bordure
کينډۍ:د هېواد مالومات پارتوګال	Modèle:Country data Portugal
کينډۍ:د هېواد مالومات آيرلېنډ	Modèle:Country data Irlande
کينډۍ:د هېواد مالومات چین	Modèle:Country data Chine
کينډۍ:د هېواد مالومات بېنين	Modèle:Country data Bénin
کينډۍ:د هېواد مالومات د کانگو جمهوريت	Modèle:Country data République du Congo
کينډۍ:ويکيسازنه	Modèle:À wikifier
کينډۍ:Familytree/end	Modèle:Arbre généalogique/fin
کينډۍ:د هېواد مالومات ترکيه	Modèle:Country data Turquie
وېشنيزه:ليکوال	Catégorie:Écrivain
کينډۍ:د هېواد مالومات قبرس	Modèle:Country data Chypre
کينډۍ:د هېواد مالومات سويتزرلاند	Modèle:Country data Suisse
کينډۍ:د هېواد مالومات فلېپين	Modèle:Country data Philippines
کينډۍ:د هېواد مالومات نايجېريا	Modèle:Country data Nigeria
کينډۍ:د هېواد مالومات آيرلنډ	Modèle:Country data Biélorussie
کينډۍ:د هېواد مالومات مالېزيا	Modèle:Country data Malaisie
کينډۍ:د هېواد مالومات ارمنستان	Modèle:Country data Arménie
کينډۍ:د هېواد مالومات زېمبابوې	Modèle:Country data Zimbabwe
کينډۍ:د هېواد مالومات ختيځ تېمور	Modèle:Country data Timor oriental
وېشنيزه:تومانچې	Catégorie:Pistolet
کينډۍ:د هېواد مالومات قزاقستان	Modèle:Country data Kazakhstan
کينډۍ:د هېواد مالومات چېلي	Modèle:Country data Chili
کينډۍ:د هېواد مالومات سلووېنيا	Modèle:Country data Slovénie
کينډۍ:د هېواد مالومات لبنان	Modèle:Country data Liban
کينډۍ:د کتاب مالوماتبکس-1	Modèle:Infobox Livre
کينډۍ:د هېواد مالومات بهوټان	Modèle:Country data Bhoutan
وېشنيزه:څارګرې ادارې	Catégorie:Service de renseignement
کينډۍ:Tlx	Modèle:Lien vers modèle avec paramètres
کينډۍ:Lang-la	Modèle:Lang-la
کينډۍ:Lang-el	Modèle:Lang-el
وېشنيزه:اخلاق	Catégorie:Éthique
د سره صليب نړيواله ټولنه	Comité international de la Croix-Rouge
وېشنيزه:چاودېدونكى مواد	Catégorie:Explosif
کينډۍ:IPA-en	Modèle:API-en
وېشنيزه:توکي	Catégorie:Équipement
کينډۍ:MMAstatsbox	Modèle:Infobox MMA
کينډۍ:مالوماتبکس لويه وچه	Modèle:Infobox Continent
وېشنيزه:پخوانی ژبې	Catégorie:Langue morte
وېشنيزه:User ja-N	Catégorie:Utilisateur ja-M
تانبه:اسلام	Portail:Islam
کينډۍ:Polytonic	Modèle:Grec ancien
کينډۍ:تانبې گرځښتپټه	Modèle:Browsebar
کينډۍ:Familytree/start	Modèle:Arbre généalogique/début
کينډۍ:نامبهمېدنه	Modèle:Homonymie
وېشنيزه:اسرائیلي جوماتونه	Catégorie:Mosquée en Israël
وېشنيزه:د ایران امپراتورۍ او پاچاهۍ	Catégorie:Perse
وېشنيزه:پوځي الوتکې	Catégorie:Avion militaire
کينډۍ:Lang-grc	Modèle:Lang-grc
کينډۍ:د هېواد مالومات کوموروس	Modèle:Country data Comores
کينډۍ:د فلسفې سرليکونه	Modèle:Palette Philosophie
کينډۍ:Lang-pt	Modèle:Lang-pt
کينډۍ:د هېواد مالومات قطر	Modèle:Country data Qatar
کينډۍ:FRA	Modèle:France
کينډۍ:د هېواد مالومات اسرایل	Modèle:Country data Israël
کينډۍ:د هېواد مالومات اوکراين	Modèle:Country data Ukraine
کينډۍ:د هېواد مالومات کولمبيا	Modèle:Country data Colombie
کينډۍ:د هېواد مالومات پاکستان	Modèle:Country data Pakistan
کينډۍ:د هېواد مالومات ګانا	Modèle:Country data Ghana
کينډۍ:د هېواد مالومات رومانیا	Modèle:Country data Roumanie
کينډۍ:د هېواد مالومات سوېلي کوريا	Modèle:Country data Corée du Sud
کينډۍ:Npov	Modèle:Désaccord de neutralité
کينډۍ:د هېواد مالومات بحرين	Modèle:Country data Bahreïn
وېشنيزه:User ja	Catégorie:Utilisateur ja
وېشنيزه:User ur	Catégorie:Utilisateur ur
وېشنيزه:User ko-N	Catégorie:Utilisateur ko-M
وېشنيزه:User ru-N	Catégorie:Utilisateur ru-M
وېشنيزه:وختتېری	Catégorie:Divertissement
وېشنيزه:تاريخپوهان	Catégorie:Historien
وېشنيزه:User de	Catégorie:Utilisateur de
وېشنيزه:User de-N	Catégorie:Utilisateur de-M
کينډۍ:د افغانستان ولايتونه	Modèle:Palette Provinces d'Afghanistan
وېشنيزه:User en-3	Catégorie:Utilisateur en-3
وېشنيزه:User en-N	Catégorie:Utilisateur en-M
آلو	Prune
وېشنيزه:User fa	Catégorie:Utilisateur fa
کينډۍ:N/A	Modèle:N/A
وېشنيزه:د اسلام پيغمبران	Catégorie:Prophète de l'islam
کينډۍ:د هېواد مالومات برونډي	Modèle:Country data Burundi
کينډۍ:د هېواد مالومات جرمني	Modèle:Country data Allemagne
کينډۍ:د هېواد مالومات بريتانيه	Modèle:Country data Royaume-Uni
وېشنيزه:مېچپوهنه	Catégorie:Géométrie
کينډۍ:د هېواد مالومات اېسټونيا	Modèle:Country data Estonie
کينډۍ:د هېواد مالومات مانټېنېګرو	Modèle:Country data Monténégro
کينډۍ:Weather box	Modèle:Climat
وېشنيزه:هنرمندان	Catégorie:Artiste
وېشنيزه:User ja-1	Catégorie:Utilisateur ja-1
وېشنيزه:ژمنۍ لوبې	Catégorie:Sport d'hiver
وېشنيزه:User ko	Catégorie:Utilisateur ko
وېشنيزه:د امريکا د متحده ايالاتو ايالتونه	Catégorie:État des États-Unis
وېشنيزه:بانکوالی	Catégorie:Système bancaire
کينډۍ:د هېواد مالومات د عاج ساحل	Modèle:Country data Côte d'Ivoire
وېشنيزه:د ایران ولایتونه	Catégorie:Province d'Iran
وېشنيزه:User ru-1	Catégorie:Utilisateur ru-1
کينډۍ:د لارښود نيوليک پر شا تگ	Modèle:Retour au sommaire de l'aide
اسلامي رخصتۍ	Fêtes islamiques
وېشنيزه:مخدره مواد	Catégorie:Consommation de psychotrope
وېشنيزه:اند	Catégorie:Pensée
وېشنيزه:لمريز غونډال	Catégorie:Système solaire
کينډۍ:د هېواد مالومات برازیل	Modèle:Country data Brésil
وېشنيزه:مخترعين	Catégorie:Inventeur
وېشنيزه:سر او غاړه	Catégorie:Tête et cou
ډبرپوهنه	Lithologie
کينډۍ:د هېواد مالومات سوازيلاند	Modèle:Country data Swaziland
وېشنيزه:ژوپوهنه	Catégorie:Zoologie
تانبه:دين	Portail:Religions et croyances
وېشنيزه:هلیکوپترونه	Catégorie:Hélicoptère
کينډۍ:د هېواد مالومات هنګري	Modèle:Country data Hongrie
وېشنيزه:د آفریقاهیوادونه	Catégorie:Pays d'Afrique
وېشنيزه:د هخامنشیانو حکمرانان	Catégorie:Empire achéménide
کينډۍ:Template reference list	Modèle:Références du modèle
وېشنيزه:حزب الله	Catégorie:Hezbollah
کينډۍ:د هېواد مالومات نيوزيلاند	Modèle:Country data Nouvelle-Zélande
وېشنيزه:القاعده	Catégorie:Al-Qaïda
وېشنيزه:User ro-3	Catégorie:Utilisateur ro-3
وېشنيزه:User ru	Catégorie:Utilisateur ru
وېشنيزه:User ru-2	Catégorie:Utilisateur ru-2
وېشنيزه:User ru-3	Catégorie:Utilisateur ru-3
وېشنيزه:User ru-4	Catégorie:Utilisateur ru-4
وېشنيزه:User ur-2	Catégorie:Utilisateur ur-2
کينډۍ:انبيا په قرآن كې	Modèle:Palette Prophètes de l'islam
کينډۍ:د افغانستان تاريخ	Modèle:Palette Histoire de l'Afghanistan
کينډۍ:Lang	Modèle:Langue
کينډۍ:د هېواد مالومات د امريکا متحده ايالات	Modèle:Country data États-Unis
وحدة الوجود	Wahdat al-wujud
کينډۍ:د هېواد مالومات ترکمنستان	Modèle:Country data Turkménistan
وېشنيزه:د ۱۹۵۷ کال زېږېدنې	Catégorie:Naissance en 1957
کينډۍ:د هېواد مالومات سهېلي کوريا	Modèle:Country data Corée du Nord
کينډۍ:د هېواد مالومات افغانستان	Modèle:Country data Afghanistan
کينډۍ:د هېواد مالومات بنگله دېش	Modèle:Country data Bangladesh
لوگر ولايت	Lôgar
کينډۍ:د پاکستان سياسي جغرافي وېش	Modèle:Palette Provinces et territoires du Pakistan
کينډۍ:امينواسيدونه	Modèle:Palette Acides aminés
وېشنيزه:افغانان	Catégorie:Personnalité afghane
وېشنيزه:بي بي سي	Catégorie:British Broadcasting Corporation
کينډۍ:Biochemical families	Modèle:Familles biochimiques
د آلمان دپاره آلترناتیف	Alternative pour l'Allemagne
وېشنيزه:آرنی	Catégorie:Article
کينډۍ:د هېواد مالومات د کانگو ډيموکراتيک جمهوريت	Modèle:Country data République démocratique du Congo
کينډۍ:ICDO	Modèle:ICDO
وېشنيزه:اوبتلونه	Catégorie:Sous-marin
وېشنيزه:ماشیندارونه	Catégorie:Pistolet mitrailleur
وېشنيزه:د پاکستان ایالتونه او سیمې	Catégorie:Province du Pakistan
وېشنيزه:ليبيا	Catégorie:Libye
وېشنيزه:افغاني رسنۍ	Catégorie:Média en Afghanistan
وېشنيزه:د افغانستان وټه	Catégorie:Économie de l'Afghanistan
کينډۍ:Infobox Language/family-color	Projet:Charte graphique/Tableau des langues
د ننگرهار پوهنتون	Université du Nangarhâr
کينډۍ:User ru-1	Modèle:Utilisateur ru-1
کينډۍ:د هېواد مالومات بېلاز	Modèle:Country data Belize
کينډۍ:دا وخت	Modèle:Calendrier aujourd'hui
کينډۍ:د هېواد مالومات کوسووا	Modèle:Country data Kosovo
کينډۍ:د هېواد مالومات ماورېتانيا	Modèle:Country data Mauritanie
کينډۍ:د هېواد مالومات ګابون	Modèle:Country data Gabon
کينډۍ:د هېواد مالومات جبوتي	Modèle:Country data Djibouti
کينډۍ:د هېواد مالومات آروبا	Modèle:Country data Aruba
کينډۍ:د هېواد مالومات سوډان	Modèle:Country data Soudan
کينډۍ:د هېواد مالومات چاډ	Modèle:Country data Tchad
وېشنيزه:روسي ساينسپوهان	Catégorie:Scientifique russe
وېشنيزه:بازارموندنه	Catégorie:Marketing
وېشنيزه:د نړۍ هېوادونه	Catégorie:Relations internationales
کينډۍ:د هېواد مالومات انټيگ او بربودا	Modèle:Country data Antigua-et-Barbuda
کينډۍ:د هېواد مالومات ګامبيا	Modèle:Country data Gambie
وېشنيزه:غږپوهنه	Catégorie:Phonologie
کينډۍ:د هېواد مالومات نامېبيا	Modèle:Country data Namibie
کينډۍ:Tnavbar-header	Modèle:Tnavbar-header
وېشنيزه:مالیه	Catégorie:Finance
وېشنيزه:روسی الوتکې	Catégorie:Avion militaire soviétique ou russe
وېشنيزه:د افغانستان ولايتونه	Catégorie:Province d'Afghanistan
وېشنيزه:د چېک خلک	Catégorie:Personnalité tchèque
وېشنيزه:آلمانی الوتکې	Catégorie:Avion militaire allemand
وېشنيزه:مرکزي بانکونه	Catégorie:Banque centrale
وېشنيزه:کيمياوي توکي	Catégorie:Élément chimique
وېشنيزه:امريکايي فيلسوفان	Catégorie:Philosophe américain
وېشنيزه:ساينسپوهان	Catégorie:Scientifique
وېشنيزه:سولګر ملتونونه	Catégorie:Entreprise d'informatique
وېشنيزه:د افغانستان پوځ	Catégorie:Forces armées de l'Afghanistan
وېشنيزه:سهېلي کوريا	Catégorie:Corée du Nord
وېشنيزه:د ليبيا خلک	Catégorie:Personnalité libyenne
وېشنيزه:د آسيا ارزونه	Catégorie:Monnaie d'Asie
وېشنيزه:ايراني سیاستوال	Catégorie:Personnalité politique iranienne
وېشنيزه:د پاکستان سياستوال	Catégorie:Personnalité politique pakistanaise
کينډۍ:د هېواد مالومات بورکينا فاسو	Modèle:Country data Burkina Faso
کينډۍ:د هېواد مالومات د منځنۍ افريقا جمهوريت	Modèle:Country data République centrafricaine
وېشنيزه:خبريالي	Catégorie:Journalisme
وېشنيزه:اوزبکستان	Catégorie:Ouzbékistan
وېشنيزه:مغولو پاچايي	Catégorie:Inde moghole
وېشنيزه:عثماني پېر	Catégorie:Empire ottoman
وېشنيزه:افغاني ليکوال	Catégorie:Écrivain afghan
د پکتيا پوهنتون	Université de Paktiyâ
کينډۍ:د هېواد مالومات پاپوا نيوګوينا	Modèle:Country data Papouasie-Nouvelle-Guinée
وېشنيزه:پاکستاني هېوادمشران	Catégorie:Président du Pakistan
وېشنيزه:مېوې	Catégorie:Fruit alimentaire
وېشنيزه:زهرلرونکي نباتونه	Catégorie:Plante toxique
وېشنيزه:د اروپا سيمې	Catégorie:Région d'Europe
وېشنيزه:د آسیا جغرافیا	Catégorie:Géographie de l'Asie
وېشنيزه:جوماتونه	Catégorie:Mosquée
وېشنيزه:د ترکیې جوماتونه	Catégorie:Mosquée en Turquie
وېشنيزه:دانټي رېټرووايرل درملونه	Catégorie:Antirétroviral
وېشنيزه:انتي بيوتيکونه	Catégorie:Antibiotique
وېشنيزه:مسکنونه	Catégorie:Analgésique
وېشنيزه:د افشاريانو حکمرانان	Catégorie:Afsharides
وېشنيزه:ددرمل شکل	Catégorie:Forme galénique
وېشنيزه:د شمېرپوهنې ډګرونه	Catégorie:Branche des mathématiques
وېشنيزه:خبري اژانس	Catégorie:Agence de presse
وېشنيزه:بشرِی حقوق	Catégorie:Droits fondamentaux
تورن	Capitaine (homonymie)
وېشنيزه:پاکستانی وېکيپېډياګران	Catégorie:Utilisateur origine Pakistan
وېشنيزه:ناټو	Catégorie:Organisation du traité de l'Atlantique Nord
وېشنيزه:پوځي وييونه	Catégorie:Glossaire militaire
وېشنيزه:غړي	Catégorie:Organe
وېشنيزه:وسلې	Catégorie:Arme
وېشنيزه:بم غورځونکي الوتکې	Catégorie:Bombardier
وېشنيزه:د بېټا-لاکټاماز انتي بيوتيکونه	Catégorie:Antibiotique bêta-lactamine
وېشنيزه:پاړسي ژبه	Catégorie:Langue persane
وېشنيزه:اېډز	Catégorie:VIH / sida
وېشنيزه:قران	Catégorie:Coran
وېشنيزه:ناروغۍ	Catégorie:Maladie
وېشنيزه:ترافيک ترانسپورت	Catégorie:Transport
وېشنيزه:لوبې	Catégorie:Discipline sportive
وېشنيزه:کورنۍ	Catégorie:Famille
وېشنيزه:قضاء	Catégorie:Justice
وېشنيزه:وټپوهان	Catégorie:Économiste
کينډۍ:د ژبې مالوماتبکس	Modèle:Infobox Langue
وېشنيزه:ځمکپوهان	Catégorie:Géographe
وېشنيزه:ولسواکي	Catégorie:Démocratie
وېشنيزه:درمل	Catégorie:Médicament
وېشنيزه:ټانکونه	Catégorie:Char d'assaut
وېشنيزه:د آفریقا د هېوادونو پلازمېنې	Catégorie:Capitale d'Afrique
وېشنيزه:ايراني هڅوب	Catégorie:Culture iranienne
وېشنيزه:د رومانیا ښارونه	Catégorie:Ville de Roumanie
وېشنيزه:کراچۍ	Catégorie:Karachi
وېشنيزه:کابل	Catégorie:Kaboul
وېشنيزه:د آسیا د هېوادونو پلازمېنې	Catégorie:Capitale d'Asie
وېشنيزه:پښتانه	Catégorie:Personnalité pachtoune
وېشنيزه:چېکي واکمنان	Catégorie:Roi de Bohême
وېشنيزه:د مسراشمیت الوتکې	Catégorie:Avion Messerschmitt
وېشنيزه:د افغانستان ژبې	Catégorie:Langue d'Afghanistan
وېشنيزه:هزاره ګان	Catégorie:Hazaras
کينډۍ:د خيبر پښتونخوا ولسوالۍ	Modèle:Palette Districts du Baloutchistan
وېشنيزه:شوبلې ضد وسلې	Catégorie:Missile antichar
وېشنيزه:مرکزي قبایلي سیمې	Catégorie:Régions tribales (Pakistan)
وېشنيزه:د افغانستان جوماتونه	Catégorie:Mosquée en Afghanistan
وېشنيزه:د قاجاريانو حکمرانان	Catégorie:Kadjars
شکريه بارکزۍ	Shukria Barakzai
وېشنيزه:افغاني ګوندونه	Catégorie:Parti politique afghan
کينډۍ:د هېواد مالومات اسپانيا	Modèle:Country data Espagne
کينډۍ:د هېواد مالومات کاناډا	Modèle:Country data Canada
کينډۍ:د هېواد مالومات بربادوس	Modèle:Country data Barbade
کينډۍ:د هېواد مالومات اردن	Modèle:Country data Jordanie
کينډۍ:د هېواد مالومات قرغزستان	Modèle:Country data Kirghizistan
کينډۍ:د هېواد مالومات لېسوتو	Modèle:Country data Lesotho
کينډۍ:د هېواد مالومات لايبېريا	Modèle:Country data Liberia
کينډۍ:د هېواد مالومات ملاوي	Modèle:Country data Malawi
کينډۍ:د هېواد مالومات مالديپ	Modèle:Country data Maldives
کينډۍ:د هېواد مالومات مغولستان	Modèle:Country data Mongolie
کينډۍ:د هېواد مالومات نايجېر	Modèle:Country data Niger
کينډۍ:د هېواد مالومات پورټو ريکو	Modèle:Country data Porto Rico
کينډۍ:د هېواد مالومات راوانډا	Modèle:Country data Rwanda
کينډۍ:د هېواد مالومات سېراليون	Modèle:Country data Sierra Leone
کينډۍ:د هېواد مالومات سورينام	Modèle:Country data Suriname
کينډۍ:د هېواد مالومات سوريه	Modèle:Country data Syrie
کينډۍ:د هېواد مالومات سېنگاپور	Modèle:Country data Singapour
کينډۍ:د هېواد مالومات يوگانډا	Modèle:Country data Ouganda
کينډۍ:د هېواد مالومات ونواتو	Modèle:Country data Vanuatu
کينډۍ:د هېواد مالومات يمن	Modèle:Country data Yémen
کينډۍ:د هېواد مالومات زېمبيا	Modèle:Country data Zambie
کينډۍ:د هېواد مالومات اېرېتېريا	Modèle:Country data Érythrée
کينډۍ:رنگ مالوماتبکس	Modèle:Infobox Couleur
وېشنيزه:د آسیا هېوادونه	Catégorie:Pays d'Asie
کينډۍ:اسلامي ولسمشریزې	Modèle:Palette Républiques islamiques
کينډۍ:آډولف هېټلر	Modèle:Palette Adolf Hitler
کينډۍ:دکارن-جعبه	Modèle:Boîte Utilisateur
کينډۍ:تصوف	Modèle:Palette Soufisme
کينډۍ:Sw icon	Modèle:Sw
وېشنيزه:مسافروړونکي الوتکې	Catégorie:Avion de ligne
کينډۍ:د هېواد مالومات عربي ټولنه	Modèle:Country data Ligue arabe
وېشنيزه:د القلوید مواد	Catégorie:Alcaloïde
وېشنيزه:خيبر پښتونخوا	Catégorie:Khyber Pakhtunkhwa
وېشنيزه:باليووډ	Catégorie:Bollywood
کينډۍ:د هېواد مالومات لوېديځه سحارا	Modèle:Country data Sahara occidental
کينډۍ:د هېواد مالومات د فالکلاند ټاپوان	Modèle:Country data Îles Malouines
نومونپوهنه	Terminologie
کينډۍ:د هېواد مالومات ګونې	Modèle:Country data Guinée
کينډۍ:د هېواد مالومات ګوينې بېساو	Modèle:Country data Guinée-Bissau
کينډۍ:وسله مالوماتبکس	Modèle:Infobox Arme
وېشنيزه:اسلامي وټه	Catégorie:Finance islamique
کينډۍ:د هېواد مالومات آذربايجان-SSR	Modèle:Country data RSS d'Azerbaïdjan
لارښود:نيوليک/انځورونه او رسنۍ	Aide:Sommaire/Images et média
لارښود:نيوليک/سرچينې او لړليکونه	Aide:Sommaire/Ressources
کينډۍ:غوږ شه	Modèle:Son
وېشنيزه:د ساسانیانو حکمرانان	Catégorie:Dynastie sassanide
وېشنيزه:سنډ	Catégorie:Sind
وېشنيزه:امريکايي بم غورځونکي الوتکې	Catégorie:Bombardier américain
کينډۍ:د هېواد مالومات مقدونيه	Modèle:Country data Macédoine
وېشنيزه:مسلمان فيلسوفان	Catégorie:Philosophe musulman
وېشنيزه:بسونه	Catégorie:Modèle de bus
وېشنيزه:تصوف	Catégorie:Soufisme
وېشنيزه:ورکړېنې	Catégorie:Fiscalité
روژه (مياشت)	Ramadan
وېشنيزه:افغاني فلمونه	Catégorie:Film afghan
وېشنيزه:امریکایی الوتکې	Catégorie:Avion militaire américain
وېشنيزه:امريکايي سندرغاړې	Catégorie:Chanteuse américaine
کينډۍ:د هېواد مالومات تانزانيا	Modèle:Country data Tanzanie
کينډۍ:د هېواد مالومات سوماليا	Modèle:Country data Somalie
وېشنيزه:پاکستاني جوماتونه	Catégorie:Mosquée au Pakistan
وېشنيزه:قراني سورتونه	Catégorie:Sourate
وېشنيزه:د لويديځ سلاوي ژبې	Catégorie:Langue slave occidentale
وېشنيزه:User en-1	Catégorie:Utilisateur en-1
وېشنيزه:افغان ښځې	Catégorie:Personnalité féminine afghane
وېشنيزه:د پاکستان څارگرې ادارې	Catégorie:Service de renseignement pakistanais
وېشنيزه:اسلامپوهان	Catégorie:Islamologue
گنگسيت	Étourdissement
دويم بريدمن	Sous-lieutenant
کينډۍ:User zh-min-nan-3	Modèle:Utilisateur zh-min-nan-3
کينډۍ:Col-2	Modèle:Booleq
ټنک ولسوالۍ	District de Tank
کينډۍ:Supranational European Bodies	Modèle:Organisations supranationales européennes
ټغ	Geai
کينډۍ:PoliticsAF	Modèle:PolitiqueAfghanistan
کوکۍ	Rhopalocères
ابو منصور ماتريدي	Abul Mansûr Al Mâturîdî
مولۍ	Radis
تانبه:پاکستان	Portail:Pakistan
هريپور ولسوالۍ	District d'Haripur
کينډۍ:Style/ril	Modèle:Style/ril
ويکيپېډيا:ډ-ځ-پ/لوستونکي	Aide:FAQ/lecteurs
ويکيپېډيا:ډ-ځ-پ/بېلابېل	Aide:FAQ/divers
کينډۍ:Style/IPA	Modèle:Style/IPA
کينډۍ:Style/yid	Modèle:Style/yid
سوفيست	Sophiste
کينډۍ:د-ن-و-ا	Modèle:Image du jour
کينډۍ:Booleq/eq2	Modèle:Booleq/eq2
ويکيپېډيا:د نن ورځې غوره ليکنه/جولای 2007	Wikipédia:Lumière sur/Juillet 2007
کينډۍ:د هېواد مالومات عمان	Modèle:Country data Oman
کينډۍ:د هېواد مالومات موزمبيق	Modèle:Country data Mozambique
کينډۍ:د هېواد مالومات کېمرون	Modèle:Country data Cameroun
بېاتریکس فون شتورخ	Beatrix von Storch
ځانګړی:اوسني بدلونونه	Spécial:Modifications récentes
Module:Coordinates	Module:Coordinates
رولا غني	Rula Ghani
د پېښور پر پوځي ښوونځي بريد	Massacre de l'école militaire de Peshawar
