Nditbonj	Japon
Nozveih	Norvège
Aiwjlanz Gunghozgoz	Irlande (pays)
Sihbanhyaz	Espagne
Meijgoz	États-Unis
Giuznamh	Terre
Vunz	Homo sapiens
Tim Berners-Lee	Tim Berners-Lee
Finlan	Finlande
Nyeiqswq	Suisse
Dujwjgiz	Turquie
Yacouh	Asie
Namzgigcouh	Antarctique
Veizgiek Bakgoh	Wikipédia
Niujyoz	New York
Vazcingdonq	Washington (district de Columbia)
Dennauj	Ordinateur
Bahliz	Paris
Linzgenj	Abraham Lincoln
Fazgoz	France
Esperanto	Espéranto
Yinghgoz	Royaume-Uni
Cunghvaz Yinzminz Gunghozgoz	Chine
Vah Fazgoz	Français
Duzbya	Poisson
Bahsih	Brésil
Ezlozswh	Russie
Ginghyiz	Cetacea
Haijhaek	Mer Noire
São Paulo	São Paulo
Dwzgoz	Allemagne
Vah Dwzgoz	Allemand
Feihgih	Avion
It	1 (nombre)
Ngeih	2 (nombre)
Sam	3 (nombre)
Seiq	4 (nombre)
Haj	5 (nombre)
Lingz	Zéro
Gwzlozdiya	Croatie
Ahsehbaiqgyangh	Azerbaïdjan
Hahsazgwswhdanj	Kazakhstan
Gujbah	Cuba
Yindunizsihya	Indonésie
Wolfgang Amadeus Mozart	Wolfgang Amadeus Mozart
Ludwig van Beethoven	Ludwig van Beethoven
Raemx	Eau
Chile	Chili
Yesu	Jésus-Christ
Ndaundeiqhaemh	Vénus (planète)
Ciencwng	Dictature
Ndaundeiqfaex	Jupiter (planète)
Dahmbwn	Voie lactée
Gohyoz	Science
Soqyoz	Mathématiques
Ronghndwen	Lune
Audaihleihya	Australie
Hoengjlungz	Dinosaure
Lech Wałęsa	Lech Wałęsa
Simlingz	Esprit
Sei	Poésie
Louis Pasteur	Louis Pasteur
Doeng Divwnq	Timor oriental
Hwzdung	Trou noir
Yangj	Oxygène
Yinhyoz	Musique
Moscow	Moscou
Saen Saelanz	Nouvelle-Zélande
Yindu	Inde
Diet	Fer
William Shakespeare	William Shakespeare
Gyaz	Potassium
Mungzguj	Mongolie
Doengz	Cuivre
Doenghgo	Plante
Gwzlinznazdaz	Grenade (pays)
Massachusetts	Massachusetts
Mou	Porc
Iran	Iran
Lao	Laos
Majlaizsihya	Malaisie
Mienjdien	Birmanie
Joseph Stalin	Joseph Staline
Cunghvaz Minzgoz	Taïwan
Daigoz	Thaïlande
Hojceh	Train
Yiednamz	Viêt Nam
Hanzgoz	Corée du Sud
Gim	Or
Feihlizbinh	Philippines
Isaac Newton	Isaac Newton
Albert Einstein	Albert Einstein
Baekging	Pékin
Ganggoj Minzcuj Gunghozgoz	République démocratique du Congo
Moq Dwzlij	New Delhi
Nizywlihya	Nigeria
Charles Darwin	Charles Darwin
Gaejsa	Jules César
Dante	Dante Alighieri
Ngaenz	Argent
Banh Gihvwnz	Ban Ki-moon
Lwgmanh	Capsicum annuum
Non	Insecte
Giceh	Automobile
Sagwzlwgbouh	Zagreb
Dunghgingh	Tokyo
Astana	Astana
Hahvaxnaz	La Havane
Vahyindi	Hindi
Neil Armstrong	Neil Armstrong
Vah Vuhwjduh	Ourdou
Ho Chi Minh Si	Hô-Chi-Minh-Ville
Cin Yesu Gauqbaiq	Véritable Jésus Église
Vah Yinghgoz	Anglais
Bangkok	Bangkok
Gizlungzpoh	Kuala Lumpur
Dong Hoi	Đồng Hới
Concepción	Concepción (Chili)
Lozmaj Daeqgoz	Empire romain
Cukgiuz	Football
Bahsihleihya	Brasilia
Santiago de Chile	Santiago
Canberrah	Canberra
Feiz	Feu
Dah Ganghgoj	Congo (fleuve)
Ndaundeiqsauqbaet	Comète
Yajgyadaz	Jakarta
Dah Yamajsenhoz	Amazone (fleuve)
Kinshasa	Kinshasa
Dayoz	Université
Wikipedia:Sandbox	Wikipédia:Bac à sable
Osasco	Osasco (Brésil)
Curitiba	Curitiba
Gungjswj	Confucius
Marilyn Monroe	Marilyn Monroe
Le Corbusier	Le Corbusier
Geidoekgauq	Christianisme
Duzroeg	Oiseau
Soujduh	Capitale
Vangz Yenfanh	Huang Xianfan
Cuenqsig	Diamant
Vah Nditbonj	Japonais
Yiebdaeuz	Wikipédia:Accueil principal
Adolf Butenandt	Adolf Butenandt
Saratov	Saratov
Dahcangzgyangh	Yangzi Jiang
Salvador Dalí	Salvador Dalí
Albrecht Dürer	Albrecht Dürer
Michelangelo	Michel-Ange
Pablo Picasso	Pablo Picasso
Abu Nuwas	Aboû Nouwâs
Cervantes	Miguel de Cervantes
Mauz Cwzdungh	Mao Zedong
Goethe	Johann Wolfgang von Goethe
Saiyaem	Vagin
Cwzyoz	Philosophie
分类:Candidates for speedy deletion	Catégorie:Wikipédia:Suppression immédiate demandée
Fouzcwngfujcujyi	Anarchisme
Swyouzcujyi	Libéralisme
Hozmaj	Homère
Dahhwzlungzgyangh	Amour (fleuve)
Kālidāsa	Kâlidâsa
Lij Beg	Li Bai
Niels Bohr	Niels Bohr
Cigminzcujyi	Colonialisme
Minzcuj	Démocratie
Cwngfuj	Gouvernement
Caenz Hij Vuengz	Qin Shi Huang
Elizabeth I	Élisabeth Ire (reine d'Angleterre)
Hanciuz	Dynastie Han
Han Vujdaeq	Han Wudi
Daiqgwzwj	Rabindranath Tagore
Ndei	Beau
Jacques Cartier	Jacques Cartier
Christopher Columbus	Christophe Colomb
James Cook	James Cook
Dahvangzhoz	Fleuve Jaune
Huhbizlez	Kubilai Khan
Doengnamzya guekgya lenzmungz	Association des nations de l'Asie du Sud-Est
Yinghlenzbangh	Commonwealth of Nations
Vah Swahili	Swahili
Dunghgingh Dayoz	Université de Tokyo
Vahgun	Langues chinoises
Mbwnnamh	Nature
Bwt	Poumon
Heiqhaeuh	Climat
Gvangvuz	Minéral
Caenleix	Vérité
Banjgaiq goucauxlun	Tectonique des plaques
Avicenna	Avicenne
Rin	Roche
Haij Rongx	Tsunami
Vwnzyoz	Littérature
分类:Vwnzyoz	Catégorie:Littérature
Hoengzlaeuzmoengh	Le Rêve dans le pavillon rouge
Ahlijsanda Daihdaeq	Alexandre le Grand
Gawqlujsw daihdaeq	Cyrus le Grand
Umar	Omar ibn al-Khattâb
Bya	Montagne
Sunh Cunghsanh	Sun Yat-sen
Ayuzvuengz	Ashoka
Ahkezbah Daihdaeq	Akbar
Yanghgangj	Hong Kong
Lengx Can	Guerre froide
Soujwj	Séoul
Sanghaij	Shanghai
Mingzci veizsaen	Restauration de Meiji
Cingciuz	Dynastie Qing
Yiednamz cancwngh	Guerre du Viêt Nam
Euclid	Euclide
Henry Ford	Henry Ford
Moq Yenz	Mo Yan
James Watt	James Watt
Karl Marx	Karl Marx
Voltaire	Voltaire
Caiz	Connaissance
James Clerk Maxwell	James Clerk Maxwell
Cij	Sein
Erwin Schrödinger	Erwin Schrödinger
Gojgaeqfangz	Mythologie
Yenzgyaucijcujyi	Fondamentalisme
Hoenz	Âme
Vah Yiednamz	Vietnamien
Sigmund Freud	Sigmund Freud
Vahdai	Thaï
Vah Yindunizsihya	Indonésien
Vahvuhswhbiedkez	Ouzbek
Fanhyiengh	Vientiane
Hingzveiz	Comportement
Lauxcij	Lao Tseu
Jean-Paul Sartre	Jean-Paul Sartre
Daep	Foie
Sainyouh	Urètre
Cu Heih	Zhu Xi
Gamjcingz	Émotion
Simleixhag	Psychologie
Swhsiengj	Pensée
Bienhcingqfap	Dialectique
Muhamed	Mahomet
Lwnzleixyoz	Éthique
Diemheiq	Haleine
Dauhgyau	Taoïsme
Suhfeicujyi	Soufisme
Vahmanggyalah	Bengali
Dangzciuz	Dynastie Tang
Dangz Daihcoeng	Tang Taizong
Ronald Reagan	Ronald Reagan
Gaggaj	Suicide
Faex	Arbre
Doenghduz ndoencag	Chordata
Byaek	Légume
Vahfan	Sanskrit
Soemj	Acide
Danqsuijvaqhozvuz	Glucide
Vujhan	Wuhan
Ciuhrin	Âge de la pierre
Mesopotamia	Mésopotamie
Guj Aigib	Égypte antique
Gizdoh vuengzciuz	Empire Gupta
Binghsiqrueg	Choléra
Ndaengq'ien	Nicotine
Seiqhauh damjhaek	Panzerkampfwagen IV
Gangsengsoq	Antibiotique
Cinghmoizsoq	Pénicilline
Cibcihginh doengcwngh	Croisades
Baknienz cancwng	Guerre de Cent Ans
Osman Daeqgoz	Empire ottoman
Vunz Veizging	Vikings
Bah Gim	Ba Jin
Vahcuengh	Zhuang (langue)
Taranto	Tarente
Yienzbit	Crayon
Aumwnz	Macao
Huz Ginjdauh	Hu Jintao
Gvangjdungh	Guangdong
Gvangjsih Bouxcuengh Swcigih	Guangxi
Suhlienz	Union des républiques socialistes soviétiques
Gauh Kunh	Charles Kao
Gvangjcouh	Canton (Chine)
Vwnh Gyahbauj	Wen Jiabao
Sihcang Swcigih	Région autonome du Tibet
Dalai Cibseiqseiq	Tenzin Gyatso
Cunghgoz Gungcanjdangj	Parti communiste chinois
Bak lingz loeg	106 (nombre)
Gouj	9 (nombre)
Daengxgoek Yinzminz Daibiuj Davei	Assemblée nationale populaire
Cunghgoz Yinzminz Cwngci Hezsangh Veiyi	Conférence consultative politique du peuple chinois
Nha Trang	Nha Trang
Breinigerberg	Breinigerberg
Nditcanj	Nissan
Vung Tau	Vũng Tàu
Daizvanh	Taïwan (île)
Lujsaenq	Lu Xun (écrivain)
Caet	7 (nombre)
Bat	8 (nombre)
Ulan Bator	Oulan-Bator
Hau	Blanc
Loeg	6 (nombre)
Makcaih	Tomate
Paltoga	Paltoga
Bahwjgan buendauj	Balkans
Cib	10 (nombre)
Haijdai	Mer Morte
Orson Welles	Orson Welles
Woody Allen	Woody Allen
Youdaezmoeg	Artiodactyla
Gouj cib sam	93 (nombre)
Bak haj cib bat	158 (nombre)
Duh Fuj	Du Fu
Vahnizbozwj	Népalais
Vahsaenqdaek	Sindhi
Rongh X	Rayon X
Sinhgyangh Veizvuzwj Swcigih	Xinjiang
Benjamin Franklin	Benjamin Franklin
Cwngciyoz	Science politique
Vah Hozloz	Minnan
Vladimir Nabokov	Vladimir Nabokov
Bouxcuengh	Zhuang (ethnie)
Cib ngeih	12 (nombre)
Cib it	11 (nombre)
Cib sam	13 (nombre)
Saenqdaek	Sind
Lauxsae	Instituteur
Bak	100 (nombre)
Gregor Mendel	Gregor Mendel
Arthur Schopenhauer	Arthur Schopenhauer
Cib seiq	14 (nombre)
Cib haj	15 (nombre)
Cib bat	18 (nombre)
Liujcouh	Liuzhou
Cib gouj	19 (nombre)
Cib caet	17 (nombre)
Cib loeg	16 (nombre)
Ngeih cib	20 (nombre)
Henri Becquerel	Henri Becquerel
Cabceiq	Magazine
Rio de Janeiro	État de Rio de Janeiro
Cigemq	Calotes versicolor
St. George's	Saint-Georges (Grenade)
Liuz Siujboh	Liu Xiaobo
Seiq cib	40 (nombre)
Vaiz	Bubalus bubalis
Bouxgun	Han (ethnie)
Sam cib	30 (nombre)
Yiuhrumz	Cerf-volant
Roegga	Corvus
Sipndangj	Chilopoda
Oliver Cromwell	Oliver Cromwell
Veizvuzwj	Ouïghours
Yinzvwnzcujyi	Humanisme
Gaemhbeg	Viol
Gveicouh	Guizhou
Bozhoz	Menthe
模板:Commonscat	Modèle:Commonscat
Ngeih cib sam	23 (nombre)
Fwen Lajbiengz	L'Internationale
Tomislav Nikolić	Tomislav Nikolić
Denyouz daengngoenz	Cellule photovoltaïque
Denhdwngj	Xian de Tiandeng
Bak loeg cib bat	168 (nombre)
Lungzcouh	Xian de Longzhou
Ningzmingz	Xian de Ningming
Dasinh	Xian de Daxin
Bak lingz caet	107 (nombre)
Emil Fischer	Emil Fischer
Dienhngoz	Xian de Tian'e
Namzdan	Xian de Nandan
Fonghsan	Xian de Fengshan
Dunghlanz	Xian de Donglan
Emil Adolf von Behring	Emil Adolf von Behring
Adolf Windaus	Adolf Windaus
Ngeih cib haj	25 (nombre)
Ngeih cib seiq	24 (nombre)
Loeg cib	60 (nombre)
Makbug	Citrus maxima
Yinzvwnz yozgoh	Lettres (culture)
Ahlahbozsugyauh	Acacia (genre)
John Keats	John Keats
Vaizcwx meijcouh	Bison d'Amérique du Nord
Ngeih cib loeg	26 (nombre)
Byajraez	Tonnerre
Liuzcai Ceiqheih	Liaozhai zhiyi
Loegseiq Saehgienh	Manifestations de la place Tian'anmen
Adam Riess	Adam Riess
Saul Perlmutter	Saul Perlmutter
Ceizraemxrouh	Tangyuan (nourriture)
Leopold Ružička	Lavoslav Ružička
Hoengqceiqlwnh	Cybernétique
Raemxmaeg	Encre
Cujluj	Zoulous
Cunghvaz Yinzminz Gunghozgoz gozgeiz	Drapeau de la République populaire de Chine
Bakbya	Col de montagne
Saihwet	Ceinture (vêtement)
Gvangjsih Swhfan Dayoz	Université normale de Guangxi
Fuzdauj Si	Fukushima (ville)
Cangzsa	Changsha
Ream	Scrotum
Bahmax	Xian autonome yao de Bama
Canghfwen	Chanteur
Andrea Palladio	Andrea Palladio
Cunghsanh Dayoz	Université Sun Yat-sen
Namzningz	Nanning
Ywgajnon	Insecticide
Cangcuz	Tibétains
Gveilinz	Guilin
Yahben Cancwngh	Première guerre de l'opium
Gangbit	Stylo-plume
Cangh Hwngz	Zhang Heng
Cuenghhag	Zhuangologie
Cunghvaz Yinzminz Gunghozgoz yanfaz	Constitution de la République populaire de Chine
Brian Schmidt	Brian P. Schmidt
Dahcuhgyangh	Rivière des Perles
Baekhaij	Beihai (Guangxi)
Nabsihcuz	Naxi
Bak ngeih cib loeg	126 (nombre)
Bak seiq cib it	141 (nombre)
Ciengqyouz	Sauce de soja
Veiginhrozsoeng Si	Aizuwakamatsu
Gouj cib	90 (nombre)
Haj cib caet	58 (nombre)
Makcaujcij	Jujubier commun
Caet cib ngeih	72 (nombre)
Cunghgoz Yinzminz Yinzhangz	Banque populaire de Chine
Sinhcuz	Hsinchu
Bak bat cib caet	187 (nombre)
Ginqsan Si	Kōriyama
Banjsingz Si	Iwaki
Sihsah ginzdauj	Îles Paracels
Gouj cib ngeih	92 (nombre)
Bat cib seiq	84 (nombre)
Nguxseiq Yindung	Mouvement du 4-Mai
Gouj cib loeg	96 (nombre)
Bak bat cib gouj	189 (nombre)
Seiq cib sam	43 (nombre)
Bak seiq cib bat	148 (nombre)
Bat cib caet	87 (nombre)
Bak loeg cib ngeih	162 (nombre)
Haj cib seiq	54 (nombre)
Huz Gyah	Hu Jia (militant)
Kim Yong	Jim Yong Kim
Bak sam cib seiq	134 (nombre)
Bat cib bat	88 (nombre)
Bouxmienh	Yao (peuple d'Asie)
Saelaem	Xian de Xilin
Gouqseiqcawj	Savior
Singgizsoq	Stéroïde sexuel
Bat cib haj	85 (nombre)
Bak ngeih cib bat	128 (nombre)
Ngeih cib caet	27 (nombre)
Sam cib haj	35 (nombre)
Loeg cib seiq	64 (nombre)
Gouj cib gouj	99 (nombre)
Bak lingz bat	108 (nombre)
Bak lingz it	101 (nombre)
Hoysala Digoz	Hoysala
Bak haj cib sam	153 (nombre)
Ndaengq	Alcali
Ciemxdin	Pieds bandés
Bak sam cib haj	135 (nombre)
Bak sam cib caet	137 (nombre)
Haj cib loeg	56 (nombre)
Bak caet cib ngeih	172 (nombre)
Bak loeg cib	160 (nombre)
Bat cib gouj	89 (nombre)
Bak bat cib ngeih	182 (nombre)
Caet cib loeg	76 (nombre)
Ngeih cib gouj	29 (nombre)
Bak caet cib sam	173 (nombre)
Bak caet cib it	171 (nombre)
Fuzsuih	Xian de Fusui
Ngouzcouh	Wuzhou
Fangzcwngzgangj	Fangchenggang
Ginhcouh	Qinzhou
Gveigangj	Guigang
Yoglinz	Yulin (Guangxi)
Baksaek	Baise (Chine)
Hohcouh	Hezhou
Hozciz	Hechi
Leizbingz	Laibin
Cungzcoj	Chongzuo
Bak gouj cib	190 (nombre)
Caet cib it	71 (nombre)
Ngeih cib bat	28 (nombre)
Bak haj cib ngeih	152 (nombre)
Haj cib gouj	59 (nombre)
Loeg cib ngeih	62 (nombre)
Gouj cib haj	95 (nombre)
Sam cib bat	38 (nombre)
Caet cib haj	75 (nombre)
Bazgveiq yozbaij	École d'Bagui
Bak lingz gouj	109 (nombre)
Bak lingz sam	103 (nombre)
Bak gouj cib gouj	199 (nombre)
Seiq cib haj	45 (nombre)
Guekcoj	Patrie
Bak haj cib	150 (nombre)
Loeg cib haj	65 (nombre)
Bak caet cib seiq	174 (nombre)
Bak bat cib	180 (nombre)
Bak it cib gouj	119 (nombre)
Sam Aen Daibyauj	Trois représentations
Hekgya	Hakka
Loeg cib bat	68 (nombre)
Bak haj cib loeg	156 (nombre)
Gouj cib caet	97 (nombre)
Gouj cib seiq	94 (nombre)
Haj cib haj	55 (nombre)
Gouj cib it	91 (nombre)
Isfara	Isfara
Bak sam cib bat	138 (nombre)
Bak it cib bat	118 (nombre)
Bat cib	80 (nombre)
Ngeih cib it	21 (nombre)
Ngeih cib ngeih	22 (nombre)
Caet cib	70 (nombre)
Haj cib	50 (nombre)
Seiq cib it	41 (nombre)
Sam cib seiq	34 (nombre)
Sam cib sam	33 (nombre)
Seiq cib caet	47 (nombre)
Sam cib it	31 (nombre)
Sam cib ngeih	32 (nombre)
Seiq cib seiq	44 (nombre)
Seiq cib loeg	46 (nombre)
Seiq cib gouj	49 (nombre)
Seiq cib bat	48 (nombre)
Sam cib caet	37 (nombre)
Sam cib gouj	39 (nombre)
Sam cib loeg	36 (nombre)
Haj cib sam	53 (nombre)
Bat cib it	81 (nombre)
Loeg cib loeg	66 (nombre)
Loeg cib sam	63 (nombre)
Haj cib ngeih	52 (nombre)
Loeg cib gouj	69 (nombre)
Caet cib sam	73 (nombre)
Caet cib seiq	74 (nombre)
Caet cib gouj	79 (nombre)
Loeg cib caet	67 (nombre)
Caet cib caet	77 (nombre)
Bat cib sam	83 (nombre)
Bat cib ngeih	82 (nombre)
Bat cib loeg	86 (nombre)
Caet cib bat	78 (nombre)
Gouj cib bat	98 (nombre)
Bak lingz seiq	104 (nombre)
Bak it cib sam	113 (nombre)
Bak lingz ngeih	102 (nombre)
Bak seiq cib seiq	144 (nombre)
Bak it cib	110 (nombre)
Bak ngeih cib it	121 (nombre)
Bak it cib seiq	114 (nombre)
Bak it cib loeg	116 (nombre)
Bak ngeih cib caet	127 (nombre)
Bak ngeih cib sam	123 (nombre)
Bak it cib haj	115 (nombre)
Bak lingz haj	105 (nombre)
Bak it cib ngeih	112 (nombre)
Bak it cib it	111 (nombre)
Bak it cib caet	117 (nombre)
Bak ngeih cib	120 (nombre)
Bak ngeih cib seiq	124 (nombre)
Bak ngeih cib haj	125 (nombre)
Bak gouj cib loeg	196 (nombre)
Bak ngeih cib ngeih	122 (nombre)
Bak loeg cib gouj	169 (nombre)
Bak ngeih cib gouj	129 (nombre)
Bak seiq cib	140 (nombre)
Bak seiq cib sam	143 (nombre)
Bak seiq cib caet	147 (nombre)
Bak sam cib it	131 (nombre)
Bak seiq cib loeg	146 (nombre)
Bak gouj cib caet	197 (nombre)
Bak seiq cib gouj	149 (nombre)
Bak sam cib ngeih	132 (nombre)
Bak haj cib caet	157 (nombre)
Bak haj cib gouj	159 (nombre)
Bak seiq cib ngeih	142 (nombre)
Bak haj cib it	151 (nombre)
Bak haj cib seiq	154 (nombre)
Bak loeg cib seiq	164 (nombre)
Bak sam cib gouj	139 (nombre)
Bak sam cib sam	133 (nombre)
Bak gouj cib bat	198 (nombre)
Bak loeg cib sam	163 (nombre)
Bak haj cib haj	155 (nombre)
Bak loeg cib haj	165 (nombre)
Bak sam cib loeg	136 (nombre)
Bak sam cib	130 (nombre)
Bak bat cib bat	188 (nombre)
Bak seiq cib haj	145 (nombre)
Bak loeg cib it	161 (nombre)
Bak gouj cib seiq	194 (nombre)
Bak bat cib it	181 (nombre)
Bak bat cib loeg	186 (nombre)
Bak gouj cib ngeih	192 (nombre)
Bak caet cib haj	175 (nombre)
Bak bat cib seiq	184 (nombre)
Bak bat cib sam	183 (nombre)
Bak gouj cib it	191 (nombre)
Bak loeg cib caet	167 (nombre)
Bak caet cib loeg	176 (nombre)
Bak caet cib caet	177 (nombre)
Bak caet cib gouj	179 (nombre)
Bak loeg cib loeg	166 (nombre)
Bak bat cib haj	185 (nombre)
Bak gouj cib haj	195 (nombre)
Bak caet cib bat	178 (nombre)
Bak gouj cib sam	193 (nombre)
Bak caet cib	170 (nombre)
Loeg cib it	61 (nombre)
Swcigih	Région autonome
Bianca Rinaldi	Bianca Rinaldi
Seiq cib ngeih	42 (nombre)
Daengloengz	Lanterne (éclairage)
Haj cib it	51 (nombre)
Vujmingz	Xian de Wuming
Bingzsiengz Si	Pingxiang (Guangxi)
Yizcou	Yizhou
Cunghgoz Gungcanjcujyi Cinghnenzdonz	Ligue de la jeunesse communiste chinoise
Daeng	Lampe
Dava	Xian autonome yao de Dahua
Maxbiencauj	Plantago asiatica
Vanzgyangh	Xian autonome maonan de Huanjiang
Duhnganh	Xian autonome yao de Du'an
Bya cingjganghsan	Massif du Jinggang
Lingzyinz	Xian de Lingyun
Lozcwngz	Xian autonome mulao de Luocheng
Denzlaem	Xian de Tianlin
Bingnamz	Xian de Pingnan (Guangxi)
Gyanghcouh Gih	District de Jiangzhou
Yougyangh	District de Youjiang
Lozyez	Xian de Leye
Cingjganghsan si	Jinggangshan
分类:Meijgoz	Catégorie:États-Unis
分类:Ezlozswh	Catégorie:Russie
分类:Yiednamz	Catégorie:Viêt Nam
分类:Doenghgo	Catégorie:Plante
分类:Lizsij	Catégorie:Histoire
分类:Gohyoz	Catégorie:Sciences
Gvangjsih Dayoz	Université du Guangxi
Bwzgingh swhfan Dayoz	Université normale de Pékin
分类:Cietyoz	Catégorie:Philosophie
Sinzningz	Bourg de Xinning
Liujgyauz	Bourg de Liuqiao
Gizgiu	Bourg de Qujiu
Gizgiulij	Bourg de Quli
Dunghmonz	Bourg de Dongmen
Sanhih	Bourg de Shanxu
Bahbwnz	Canton de Bapen
Dunghloz	Bourg de Dongluo
Lungzdouz	Canton de Longtou
Cunghdungh	Bourg de Zhongdong
Canghbingz	Canton de Changping
Danielle Winits	Danielle Winits
Sausenhdui	Jeunes pionniers de Chine
Veiz Gozcingh	Wei Guoqing
Mak	Fruit (alimentation humaine)
模板:Userbox	Modèle:BUtilisateur
分类:Guekgya	Catégorie:Pays
分类:Cunghvaz minzcuz	Catégorie:Groupe ethnique de Chine
分类:Mbwnnamh	Catégorie:Nature
模板:Bot	Modèle:Bot
模板:Documentation	Modèle:Documentation
Wikipedia:Seqgih	Wikipédia:Accueil de la communauté
分类:用户语言	Catégorie:Wikipédiens par langue
Sung Jae-ki	Sung Jae-ki
模板:Softredirect	Modèle:Redirection douce
模板:Db	Modèle:Suppression Immédiate
分类:Vah	Catégorie:Langue
分类:Veizgiek Bakgoh	Catégorie:Wikipédia
模板:Navbox	Modèle:Méta palette de navigation
模板:!	Modèle:!
模板:Babel	Modèle:Boîte Babel
模板:Reflist	Modèle:Références
Batgak	Badianier
模板:User de	Modèle:Utilisateur de
模板:User en-1	Modèle:Utilisateur en-1
模板:User en-0	Modèle:Utilisateur en-0
模板:User sk	Modèle:Utilisateur sk
分类:Ahsehbaiqgyangh	Catégorie:Azerbaïdjan
模板:Mod	Modèle:Mod
模板:Welcome	Modèle:Bienvenue nouveau
模板:Wikipediasister	Modèle:Projets Wikimedia
模板:Documentation/docname	Modèle:Documentation/docname
模板:Time ago	Modèle:Time ago
分类:User en	Catégorie:Utilisateur en
分类:User zh	Catégorie:Utilisateur zh
分类:User zh-N	Catégorie:Utilisateur zh-M
模板:User zh	Modèle:Utilisateur zh
模板:Cite web	Modèle:Lien web
模板:Pp-template	Modèle:Protection
模板:User language-N	Modèle:Babel field M
模板:Documentation subpage	Modèle:Sous-page de documentation
模板:Cunghgoz	Modèle:Palette Subdivisions de la Chine
模板:Disambig	Modèle:Homonymie
分类:Gvangjcouh	Catégorie:Canton (Chine)
分类:User sk	Catégorie:Utilisateur sk
模板:User zh-yue	Modèle:Utilisateur yüt
分类:User sk-N	Catégorie:Utilisateur sk-M
分类:Gvangjdungh	Catégorie:Guangdong
模板:Lang	Modèle:Langue
模板:Merge	Modèle:À fusionner
分类:Daizvanh	Catégorie:Taïwan
分类:Doeng Divwnq	Catégorie:Timor oriental
分类:Bwzgingh	Catégorie:Pékin
分类:Byaek	Catégorie:Légume
分类:Mak	Catégorie:Fruit alimentaire
分类:Gvangjsih	Catégorie:Guangxi
分类:Soujduh	Catégorie:Capitale de pays
分类:Cunghvaz Yinzminz Gunghozgoz	Catégorie:République populaire de Chine
分类:Bouxcuengh	Catégorie:Zhuang
Cunghgoz	China
Trojany	Trojany (Mazovie)
分类:Biengz Yacouh	Catégorie:Pays d'Asie
分类:Namzningz	Catégorie:Nanning
模板:Gvangjsih	Modèle:Palette Guangxi
模板:Gvangjdungh	Modèle:Palette Guangdong
分类:Liuxzouq	Catégorie:Liuzhou
模板:Nobots	Modèle:Nobots
Song guj baenqluxsae	Double-hélice
特殊:最近更改	Spécial:Modifications récentes
